Tanggal,Positif (Indonesia),Dirawat (Indonesia),Sembuh (Indonesia),Meninggal (Indonesia),Meninggal (Jakarta),Sembuh (Jakarta),Self-Isolation (Jakarta),Dirawat (Jakarta),Positif (Jakarta),Positif Aktif (Jakarta),Positif Harian (Indonesia),Dirawat Harian (Indonesia),Sembuh Harian (Indonesia),Meninggal Harian (Indonesia),Meninggal Harian (Jakarta),Sembuh Harian (Jakarta),Self-Isolation Harian (Jakarta),Dirawat Harian (Jakarta),Positif Harian (Jakarta),Positif Aktif Harian (Jakarta)
1/29/2020,0,0,0,0,0,0,0,0,0,0,0,0,0,0,0,0,0,0,0,0
3/1/2020,0,0,0,0,0,0,0,0,0,0,0,0,0,0,0,0,0,0,0,0
3/2/2020,2,2,0,0,0,0,0,0,0,0,2,2,0,0,0,0,0,0,0,0
3/3/2020,2,2,0,0,1,0,0,2,3,2,0,0,0,0,1,0,0,2,3,2
3/4/2020,2,2,0,0,1,0,0,2,3,2,0,0,0,0,0,0,0,0,0,0
3/5/2020,2,2,0,0,3,0,0,4,7,4,0,0,0,0,2,0,0,2,4,2
3/6/2020,4,4,0,0,3,0,0,4,7,4,2,2,0,0,0,0,0,0,0,0
3/7/2020,4,4,0,0,3,0,0,4,7,4,0,0,0,0,0,0,0,0,0,0
3/8/2020,6,6,0,0,3,0,0,4,7,4,2,2,0,0,0,0,0,0,0,0
3/9/2020,19,19,0,0,3,0,0,31,34,31,13,13,0,0,0,0,0,27,27,27
3/10/2020,27,25,2,0,3,0,0,31,34,31,8,6,2,0,0,0,0,0,0,0
3/11/2020,34,31,2,1,3,0,0,33,36,33,7,6,0,1,0,0,0,2,2,2
3/12/2020,34,31,2,1,5,0,0,57,62,57,0,0,0,0,2,0,0,24,26,24
3/13/2020,69,63,2,4,7,0,0,65,72,65,35,32,0,3,2,0,0,8,10,8
3/14/2020,96,83,8,5,9,0,0,70,79,70,27,20,6,1,2,0,0,5,7,5
3/15/2020,117,104,8,5,11,0,0,84,95,84,21,21,0,0,2,0,0,14,16,14
3/16/2020,134,121,8,5,12,0,7,78,97,85,17,17,0,0,1,0,7,-6,2,1
3/17/2020,172,158,9,5,12,0,27,83,122,110,38,37,1,0,0,0,20,5,25,25
3/18/2020,227,197,11,19,15,12,42,91,160,133,55,39,2,14,3,12,15,8,38,23
3/19/2020,309,269,15,25,19,13,57,121,210,178,82,72,4,6,4,1,15,30,50,45
3/20/2020,369,320,17,32,20,13,66,125,224,191,60,51,2,7,1,0,9,4,14,13
3/21/2020,450,392,20,38,23,17,71,157,268,228,81,72,3,6,3,4,5,32,44,37
3/22/2020,514,437,29,48,29,21,77,177,304,254,64,45,9,10,6,4,6,20,36,26
3/23/2020,579,500,30,49,29,22,79,225,355,304,65,63,1,1,0,1,2,48,51,50
3/24/2020,686,601,30,55,34,23,109,260,426,369,107,101,0,6,5,1,30,35,71,65
3/25/2020,790,701,31,58,43,27,112,290,472,402,104,100,1,3,9,4,3,30,46,33
3/26/2020,893,780,35,78,49,29,113,324,515,437,103,79,4,20,6,2,1,34,43,35
3/27/2020,1046,913,46,87,57,31,132,346,566,478,153,133,11,9,8,2,19,22,51,41
3/28/2020,1155,994,59,102,62,43,134,364,603,498,109,81,13,15,5,12,2,18,37,20
3/29/2020,1285,1107,64,114,67,48,151,435,701,586,130,113,5,12,5,5,17,71,98,88
3/30/2020,1414,1217,75,122,78,49,151,449,727,600,129,110,11,8,11,1,0,14,26,14
3/31/2020,1528,1311,81,136,84,49,157,451,741,608,114,94,6,14,6,0,6,2,14,8
4/1/2020,1677,1417,103,157,90,51,176,499,816,675,149,106,22,21,6,2,19,48,75,67
4/2/2020,1790,1508,112,170,95,54,195,565,909,760,113,91,9,13,5,3,19,66,93,85
4/3/2020,1986,1671,134,181,98,56,209,627,990,836,196,163,22,11,3,2,14,62,81,76
4/4/2020,2092,1751,150,191,99,58,223,691,1071,914,106,80,16,10,1,2,14,64,81,78
4/5/2020,2273,1911,164,198,123,64,279,685,1151,964,181,160,14,7,24,6,56,-6,80,50
4/6/2020,2491,2090,192,209,131,68,317,783,1299,1100,218,179,28,11,8,4,38,98,148,136
4/7/2020,2738,2313,204,221,141,69,338,895,1443,1233,247,223,12,12,10,1,21,112,144,133
4/8/2020,2956,2494,222,240,144,75,357,976,1552,1333,218,181,18,19,3,6,19,81,109,100
4/9/2020,3293,2761,252,280,155,82,405,1077,1719,1482,337,267,30,40,11,7,48,101,167,149
4/10/2020,3512,2924,282,306,156,82,433,1139,1810,1572,219,163,30,26,1,0,28,62,91,90
4/11/2020,3842,3229,286,327,168,142,441,1152,1903,1593,330,305,4,21,12,60,8,13,93,21
4/12/2020,4241,3509,359,373,195,142,468,1277,2082,1745,399,280,73,46,27,0,27,125,179,152
4/13/2020,4557,3778,380,399,209,142,521,1370,2242,1891,316,269,21,26,14,0,53,93,160,146
4/14/2020,4839,3954,426,459,243,163,558,1385,2349,1943,282,176,46,60,34,21,37,15,107,52
4/15/2020,5136,4221,446,469,246,164,613,1424,2447,2037,297,267,20,10,3,1,55,39,98,94
4/16/2020,5516,4472,548,496,248,202,619,1601,2670,2220,380,251,102,27,2,38,6,177,223,183
4/17/2020,5923,4796,607,520,250,203,643,1727,2823,2370,407,324,59,24,2,1,24,126,153,150
4/18/2020,6248,5082,631,535,257,206,670,1769,2902,2439,325,286,24,15,7,3,27,42,79,69
4/19/2020,6575,5307,686,582,292,207,695,1839,3033,2534,327,225,55,47,35,1,25,70,131,95
4/20/2020,6760,5423,747,590,297,237,752,1826,3112,2578,185,116,61,8,5,30,57,-13,79,44
4/21/2020,7135,5677,842,616,305,286,753,1935,3279,2688,375,254,95,26,8,49,1,109,167,110
4/22/2020,7418,5870,913,635,308,291,815,1985,3399,2800,283,193,71,19,3,5,62,50,120,112
4/23/2020,7775,6168,960,647,316,292,888,2010,3506,2898,357,298,47,12,8,1,73,25,107,98
4/24/2020,8211,6520,1002,689,331,327,959,1988,3605,2947,436,352,42,42,15,35,71,-22,99,49
4/25/2020,8607,6845,1042,720,350,334,1050,1947,3681,2997,396,325,40,31,19,7,91,-41,76,50
4/26/2020,8882,7032,1107,743,357,338,1099,1952,3746,3051,275,187,65,23,7,4,49,5,65,54
4/27/2020,9096,7180,1151,765,375,338,1169,1950,3832,3119,214,148,44,22,18,0,70,-2,86,68
4/28/2020,9511,7484,1254,773,379,341,1206,2024,3950,3230,415,304,103,8,4,3,37,74,118,111
4/29/2020,9771,7596,1391,784,381,412,1238,2002,4033,3240,260,112,137,11,2,71,32,-22,83,10
4/30/2020,10118,7804,1522,792,381,412,1272,2073,4138,3345,347,208,131,8,0,0,34,71,105,105
5/1/2020,10551,8160,1591,800,393,427,1312,2151,4283,3463,433,356,69,8,12,15,40,78,145,118
5/2/2020,10843,8347,1665,831,400,562,1304,2089,4355,3393,292,187,74,31,7,135,-8,-62,72,-70
5/3/2020,11192,8471,1876,845,410,622,1323,2062,4417,3385,349,124,211,14,10,60,19,-27,62,-8
5/4/2020,11587,8769,1954,864,412,650,1330,2080,4472,3410,395,298,78,19,2,28,7,18,55,25
5/5/2020,12071,9002,2197,872,414,711,1370,2146,4641,3516,484,233,243,8,2,61,40,66,169,106
5/6/2020,12438,9226,2317,895,420,713,1381,2195,4709,3576,367,224,120,23,6,2,11,49,68,60
5/7/2020,12776,9465,2381,930,430,718,1431,2196,4775,3627,338,239,64,35,10,5,50,1,66,51
5/8/2020,13112,9675,2494,943,431,763,1426,2281,4901,3707,336,210,113,13,1,45,-5,85,126,80
5/9/2020,13645,10079,2607,959,437,767,1442,2312,4958,3754,533,404,113,16,6,4,16,31,57,47
5/10/2020,14032,10361,2698,973,444,803,1533,2360,5140,3893,387,282,91,14,7,36,91,48,182,139
5/11/2020,14265,10393,2881,991,453,836,1648,2258,5195,3906,233,32,183,18,9,33,115,-102,55,13
5/12/2020,14749,10679,3063,1007,457,1262,1741,1843,5303,3584,484,286,182,16,4,426,93,-415,108,-322
5/13/2020,15438,11123,3287,1028,461,1277,1866,1833,5437,3699,689,444,224,21,4,15,125,-10,134,115
5/14/2020,16006,11445,3518,1043,466,1279,1995,1877,5617,3872,568,322,231,15,5,2,129,44,180,173
5/15/2020,16496,11617,3803,1076,474,1286,2019,1900,5679,3919,490,172,285,33,8,7,24,23,62,47
5/16/2020,17025,12025,3911,1089,475,1292,2120,1908,5795,4028,529,408,108,13,1,6,101,8,116,109
5/17/2020,17514,12237,4129,1148,478,1295,2217,1932,5922,4149,489,212,218,59,3,3,97,24,127,121
5/18/2020,18010,12495,4324,1191,483,1301,2266,1946,5996,4212,496,258,195,43,5,6,49,14,74,63
5/19/2020,18496,12808,4467,1221,487,1417,2213,1936,6053,4149,486,313,143,30,4,116,-53,-10,57,-63
5/20/2020,19189,13372,4575,1242,493,1425,2263,1969,6150,4232,693,564,108,21,6,8,50,33,97,83
5/21/2020,20162,14046,4838,1278,498,1536,2231,1955,6220,4186,973,674,263,36,5,111,-32,-14,70,-46
5/22/2020,20796,14413,5057,1326,501,1558,2282,1975,6316,4257,634,367,219,48,3,22,51,20,96,71
5/23/2020,21745,15145,5249,1351,504,1587,2346,2006,6443,4352,949,732,192,25,3,29,64,31,127,95
5/24/2020,22271,15497,5402,1372,505,1594,2431,2031,6561,4462,526,352,153,21,1,7,85,25,118,110
5/25/2020,22750,15717,5642,1391,506,1648,2430,2044,6628,4474,479,220,240,19,1,54,-1,13,67,12
5/26/2020,23165,15870,5877,1418,508,1678,2459,2044,6689,4503,415,153,235,27,2,30,29,0,61,29
5/27/2020,23851,16321,6057,1473,510,1698,2584,2034,6826,4618,686,451,180,55,2,20,125,-10,137,115
5/28/2020,24538,16802,6240,1496,514,1719,2641,2055,6929,4696,687,481,183,23,4,21,57,21,103,78
5/29/2020,25216,17204,6492,1520,517,1807,2722,2007,7053,4729,678,402,252,24,3,88,81,-48,124,33
5/30/2020,25773,17185,7015,1573,519,2003,2781,1848,7151,4629,557,-19,523,53,2,196,59,-159,98,-100
5/31/2020,26473,17552,7308,1613,520,2102,2827,1823,7272,4650,700,367,293,40,1,99,46,-25,121,21
6/1/2020,26940,17662,7637,1641,521,2246,2822,1794,7383,4616,467,110,329,28,1,144,-5,-29,111,-34
6/2/2020,27549,17951,7935,1663,525,2405,2786,1743,7459,4529,609,289,298,22,4,159,-36,-51,76,-87
6/3/2020,28233,18129,8406,1698,529,2534,2777,1699,7539,4476,684,178,471,35,4,129,-9,-44,80,-53
6/4/2020,28818,18205,8892,1721,530,2607,2793,1670,7600,4463,585,76,486,23,1,73,16,-29,61,-13
6/5/2020,29521,18308,9443,1770,532,2751,2768,1633,7684,4401,703,103,551,49,2,144,-25,-37,84,-62
6/6/2020,30514,18806,9907,1801,535,2840,2776,1635,7786,4411,993,498,464,31,3,89,8,2,102,10
6/7/2020,31186,18837,10498,1851,537,3170,2794,1445,7946,4239,672,31,591,50,2,330,18,-190,160,-172
6/8/2020,32033,19246,10904,1883,538,3205,2846,1448,8037,4294,847,409,406,32,1,35,52,3,91,55
6/9/2020,33076,19739,11414,1923,547,3369,2918,1442,8276,4360,1043,493,510,40,9,164,72,-6,239,66
6/10/2020,34316,20228,12129,1959,551,3517,2928,1427,8423,4355,1240,489,715,36,4,148,10,-15,147,-5
6/11/2020,35295,20659,12636,2000,555,3664,2887,1446,8552,4333,979,431,507,41,4,147,-41,19,129,-22
6/12/2020,36406,21145,13213,2048,561,3780,2863,1424,8628,4287,1111,486,577,48,6,116,-24,-22,76,-46
6/13/2020,37420,21553,13776,2091,564,3840,2925,1419,8748,4344,1014,408,563,43,3,60,62,-5,120,57
6/14/2020,38277,21612,14531,2134,571,4091,2833,1368,8863,4201,857,59,755,43,7,251,-92,-51,115,-143
6/15/2020,39294,21973,15123,2198,580,4198,2800,1390,8968,4190,1017,361,592,64,9,107,-33,22,105,-11
6/16/2020,40400,22466,15703,2231,583,4329,2764,1416,9092,4180,1106,493,580,33,3,131,-36,26,124,-10
6/17/2020,41431,22912,16243,2276,588,4444,2775,1402,9209,4177,1031,446,540,45,5,115,11,-14,117,-3
6/18/2020,42762,23625,16798,2339,594,4592,2822,1377,9385,4199,1331,713,555,63,6,148,47,-25,176,22
6/19/2020,43803,24081,17349,2373,599,4682,2862,1382,9525,4244,1041,456,551,34,5,90,40,5,140,45
6/20/2020,45029,24717,17883,2429,603,4821,2939,1340,9703,4279,1226,636,534,56,4,139,77,-42,178,35
6/21/2020,45891,25022,18404,2465,615,5054,2874,1287,9830,4161,862,305,521,36,12,233,-65,-53,127,-118
6/22/2020,46845,25610,18735,2500,618,5128,2901,1310,9957,4211,954,588,331,35,3,74,27,23,127,50
6/23/2020,47896,26120,19241,2535,619,5228,2957,1319,10123,4276,1051,510,506,35,1,100,56,9,166,65
6/24/2020,49009,26778,19658,2573,628,5322,2978,1349,10277,4327,1113,658,417,38,9,94,21,30,154,51
6/25/2020,50187,27118,20449,2620,631,5435,3068,1338,10472,4406,1178,340,791,47,3,113,90,-11,195,79
6/26/2020,51427,27411,21333,2683,632,5542,3136,1330,10640,4466,1240,293,884,63,1,107,68,-8,168,60
6/27/2020,52812,28183,21909,2720,632,5610,3256,1355,10853,4611,1385,772,576,37,0,68,120,25,213,145
6/28/2020,54010,28320,22936,2754,635,5865,3163,1322,10985,4485,1198,137,1027,34,3,255,-93,-33,132,-126
6/29/2020,55092,28487,23800,2805,636,6118,3299,1027,11080,4326,1082,167,864,51,1,253,136,-295,95,-159
6/30/2020,56385,28703,24806,2876,641,6512,3172,951,11276,4123,1293,216,1006,71,5,394,-127,-76,196,-203
7/1/2020,57770,29241,25595,2934,644,6680,3269,889,11482,4158,1385,538,789,58,3,168,97,-62,206,35
7/2/2020,59394,29740,26667,2987,646,6871,3356,804,11677,4160,1624,499,1072,53,2,191,87,-85,195,2
7/3/2020,60695,30091,27568,3036,648,7109,3331,736,11824,4067,1301,351,901,49,2,238,-25,-68,147,-93
7/4/2020,62142,30834,28219,3089,650,7377,3366,646,12039,4012,1447,743,651,53,2,268,35,-90,215,-55
7/5/2020,63749,31473,29105,3171,658,7663,3390,584,12295,3974,1607,639,886,82,8,286,24,-62,256,-38
7/6/2020,64958,31798,29919,3241,658,8033,3340,495,12526,3835,1209,325,814,70,0,370,-50,-89,231,-139
7/7/2020,66226,32132,30785,3309,664,8277,3379,405,12725,3784,1268,334,866,68,6,244,39,-90,199,-51
7/8/2020,68079,33135,31585,3359,667,8429,3556,417,13069,3973,1853,1003,800,50,3,152,177,12,344,189
7/9/2020,70736,34668,32651,3417,677,8647,3584,451,13359,4035,2657,1533,1066,58,10,218,28,34,290,62
7/10/2020,72347,35349,33529,3469,684,8825,3613,476,13598,4089,1611,681,878,52,7,178,29,25,239,54
7/11/2020,74018,35764,34719,3535,690,9040,3732,495,13957,4227,1671,415,1190,66,6,215,119,19,359,138
7/12/2020,75699,36455,35638,3606,702,9200,3905,554,14361,4459,1681,691,919,71,12,160,173,59,404,232
7/13/2020,76981,36636,36689,3656,710,9408,3924,597,14639,4521,1282,181,1051,50,8,208,19,43,278,62
7/14/2020,78572,37226,37636,3710,714,9528,4053,619,14914,4672,1591,590,947,54,4,120,129,22,275,151
7/15/2020,80094,37247,39050,3797,720,9721,4041,691,15173,4732,1522,21,1414,87,6,193,-12,72,259,60
7/16/2020,81668,37450,40345,3873,722,9857,4110,777,15466,4887,1574,203,1295,76,2,136,69,86,293,155
7/17/2020,83130,37339,41834,3957,731,9994,4156,826,15707,4982,1462,-111,1489,84,9,137,46,49,241,95
7/18/2020,84882,37598,43268,4016,740,10117,4289,892,16038,5181,1752,259,1434,59,9,123,133,66,331,199
7/19/2020,86521,36977,45401,4143,748,10444,4236,923,16351,5159,1639,-621,2133,127,8,327,-53,31,313,-22
7/20/2020,88214,36998,46977,4239,749,10602,4335,1026,16712,5361,1693,21,1576,96,1,158,99,103,361,202
7/21/2020,89869,37083,48466,4320,758,10864,4458,1073,17153,5531,1655,85,1489,81,9,262,123,47,441,170
7/22/2020,91751,37037,50255,4459,766,11187,4383,1193,17529,5576,1882,-46,1789,139,8,323,-75,120,376,45
7/23/2020,93657,36917,52164,4576,767,11302,4675,1201,17945,5876,1906,-120,1909,117,1,115,292,8,416,300
7/24/2020,95418,36808,53945,4665,768,11585,4577,1300,18230,5877,1761,-109,1781,89,1,283,-98,99,285,1
7/25/2020,97286,37218,55354,4714,769,11715,4729,1410,18623,6139,1868,410,1409,49,1,130,152,110,393,262
7/26/2020,98778,37342,56655,4781,779,11889,4842,1491,19001,6333,1492,124,1301,67,10,174,113,81,378,194
7/27/2020,100303,37292,58173,4838,782,11996,4993,1702,19473,6695,1525,-50,1518,57,3,107,151,211,472,362
7/28/2020,102051,36611,60539,4901,795,12373,4869,1848,19885,6717,1748,-681,2366,63,13,377,-124,146,412,22
7/29/2020,104432,37319,62138,4975,820,12613,5093,1944,20470,7037,2381,708,1599,74,25,240,224,96,585,320
7/30/2020,106336,36986,64292,5058,821,12801,5098,2049,20769,7147,1904,-333,2154,83,1,188,5,105,299,110
7/31/2020,108376,37338,65907,5131,836,13208,4974,2183,21201,7157,2040,352,1615,73,15,407,-124,134,432,10
8/1/2020,109936,36824,67919,5193,852,13887,4683,2153,21575,6836,1560,-514,2012,62,16,679,-291,-30,374,-321
8/2/2020,111455,37244,68975,5236,852,14027,4916,2159,21954,7075,1519,420,1056,43,0,140,233,6,379,239
8/3/2020,113134,37595,70237,5302,867,14165,5084,2327,22443,7411,1679,351,1262,66,15,138,168,168,489,336
8/4/2020,115056,37618,72050,5388,880,14381,5216,2432,22909,7648,1922,23,1813,86,13,216,132,105,466,237
8/5/2020,116871,37530,73889,5452,895,14760,5128,2483,23266,7611,1815,-88,1839,64,15,379,-88,51,357,-37
8/6/2020,118753,37587,75645,5521,908,15006,5397,2552,23863,7949,1882,57,1756,69,13,246,269,69,597,338
8/7/2020,121226,38076,77557,5593,922,15201,5803,2595,24521,8398,2473,489,1912,72,14,195,406,43,658,449
8/8/2020,123503,38539,79306,5658,934,15710,6110,2488,25242,8598,2277,463,1749,65,12,509,307,-107,721,200
8/9/2020,125396,38721,80952,5723,939,16268,6091,2416,25714,8507,1893,182,1646,65,5,558,-19,-72,472,-91
8/10/2020,127083,39082,82236,5765,940,16446,6252,2555,26193,8807,1687,361,1284,42,1,178,161,139,479,300
8/11/2020,128776,39242,83710,5824,953,16927,6236,2548,26664,8784,1693,160,1474,59,13,481,-16,-7,471,-23
8/12/2020,130718,39017,85798,5903,968,17349,6208,2717,27242,8925,1942,-225,2088,79,15,422,-28,169,578,141
8/13/2020,132816,39290,87558,5968,981,17838,6330,2714,27863,9044,2098,273,1760,65,13,489,122,-3,621,119
8/14/2020,135123,39484,89618,6021,985,18528,6331,2594,28438,8925,2307,194,2060,53,4,690,1,-120,575,-119
8/15/2020,137468,40076,91321,6071,991,18974,6457,2614,29036,9071,2345,592,1703,50,6,446,126,20,598,146
8/16/2020,139549,40296,93103,6150,995,19708,6284,2567,29554,8851,2081,220,1782,79,4,734,-173,-47,518,-220
8/17/2020,141370,40705,94458,6207,1011,19916,6514,2651,30092,9165,1821,409,1355,57,16,208,230,84,538,314
8/18/2020,143043,40460,96306,6277,1028,20505,6602,2462,30597,9064,1673,-245,1848,70,17,589,88,-189,505,-101
8/19/2020,144945,39942,98657,6346,1046,21069,6488,2559,31162,9047,1902,-518,2351,69,18,564,-114,97,565,-17
8/20/2020,147211,40119,100674,6418,1061,21795,6357,2544,31757,8901,2266,177,2017,72,15,726,-131,-15,595,-146
8/21/2020,149408,39917,102991,6500,1076,22228,6518,2576,32398,9094,2197,-202,2317,82,15,433,161,32,641,193
8/22/2020,151498,39706,105198,6594,1091,22877,6269,2762,32999,9031,2090,-211,2207,94,15,649,-249,186,601,-63
8/23/2020,153535,39355,107500,6680,1107,23567,6040,2922,33636,8962,2037,-351,2302,86,16,690,-229,160,637,-69
8/24/2020,155412,37593,111060,6759,1112,25463,5090,2630,34295,7720,1877,-1762,3560,79,5,1896,-950,-292,659,-1242
8/25/2020,157859,38134,112867,6858,1129,25986,5130,2686,34931,7816,2447,541,1807,99,17,523,40,56,636,96
8/26/2020,160165,37812,115409,6944,1144,26750,4978,2770,35642,7748,2306,-322,2542,86,15,764,-152,84,711,-68
8/27/2020,162884,37245,118575,7064,1147,28288,4499,2528,36462,7027,2719,-567,3166,120,3,1538,-479,-242,820,-721
8/28/2020,165887,37818,120900,7169,1154,29169,4128,2827,37278,6955,3003,573,2325,105,7,881,-371,299,816,-72
8/29/2020,169195,39132,122802,7261,1172,29768,4414,2812,38166,7226,3308,1314,1902,92,18,599,286,-15,888,271
8/30/2020,172053,40525,124185,7343,1186,30134,4945,3015,39280,7960,2858,1393,1383,82,14,366,531,203,1114,734
8/31/2020,174796,41420,125959,7417,1202,30538,5281,3288,40309,8569,2743,895,1774,74,16,404,336,273,1029,609
9/1/2020,177571,42009,128057,7505,1219,31267,5423,3341,41250,8764,2775,589,2098,88,17,729,142,53,941,195
9/2/2020,180646,43059,129971,7616,1237,31741,5757,3568,42303,9325,3075,1050,1914,111,18,474,334,227,1053,561
9/3/2020,184268,44463,132055,7750,1253,32424,6323,3709,43709,10032,3622,1404,2084,134,16,683,566,141,1406,707
9/4/2020,187537,45524,134181,7832,1260,33260,6257,3827,44604,10084,3269,1061,2126,82,7,836,-66,118,895,52
9/5/2020,190665,46324,136401,7940,1277,33991,6501,3677,45446,10178,3128,800,2220,108,17,731,244,-150,842,94
9/6/2020,194109,47509,138575,8025,1289,34738,6582,4082,46691,10664,3444,1185,2174,85,12,747,81,405,1245,486
9/7/2020,196989,48207,140652,8130,1318,35431,6706,4341,47796,11047,2880,698,2077,105,29,693,124,259,1105,383
9/8/2020,200035,48847,142958,8230,1330,36451,6598,4432,48811,11030,3046,640,2306,100,12,1020,-108,91,1015,-17
9/9/2020,203342,49806,145200,8336,1347,37245,6691,4554,49837,11245,3307,959,2242,106,17,794,93,122,1026,215
9/10/2020,207203,51237,147510,8456,1365,38226,6968,4728,51287,11696,3861,1431,2310,120,18,981,277,174,1450,451
9/11/2020,210940,52179,150217,8544,1382,39115,7143,4681,52321,11824,3737,942,2707,88,17,889,175,-47,1034,128
9/12/2020,214746,53638,152458,8650,1404,40183,7490,4684,53761,12174,3806,1459,2241,106,22,1068,347,3,1440,350
9/13/2020,218382,54649,155010,8723,1410,41014,7791,4649,54864,12440,3636,1011,2552,73,6,831,301,-35,1103,266
9/14/2020,221523,54277,158405,8841,1440,42325,7530,4631,55926,12161,3141,-372,3395,118,30,1311,-261,-18,1062,-279
9/15/2020,225030,55000,161065,8965,1468,43306,7711,4468,56953,12179,3507,723,2660,124,28,981,181,-163,1027,18
9/16/2020,228993,55792,164101,9100,1498,44251,7907,4802,58458,12709,3963,792,3036,135,30,945,196,334,1505,530
9/17/2020,232628,56720,166686,9222,1513,45207,8013,4739,59472,12752,3635,928,2585,122,15,956,106,-63,1014,43
9/18/2020,236519,56409,170774,9336,1535,46235,8450,4655,60875,13105,3891,-311,4088,114,22,1028,437,-84,1403,353
9/19/2020,240687,56889,174350,9448,1546,47260,8696,4305,61807,13001,4168,480,3576,112,11,1025,246,-350,932,-104
9/20/2020,244676,57796,177327,9553,1561,49209,8297,3819,62886,12116,3989,907,2977,105,15,1949,-399,-486,1079,-885
9/21/2020,248852,58378,180797,9677,1592,49630,9225,3749,64196,12974,4176,582,3470,124,31,421,928,-70,1310,858
9/22/2020,252923,58788,184298,9837,1624,50473,9380,3841,65318,13221,4071,410,3501,160,32,843,155,92,1122,247
9/23/2020,257388,59453,187958,9977,1650,51578,9611,3666,66505,13277,4465,665,3660,140,26,1105,231,-175,1187,56
9/24/2020,262022,60064,191853,10105,1664,52742,9714,3518,67638,13232,4634,611,3895,128,14,1164,103,-148,1133,-45
9/25/2020,266845,60431,196196,10218,1677,54352,10027,2871,68927,12898,4823,367,4343,113,13,1610,313,-647,1289,-334
9/26/2020,271339,61628,199403,10308,1679,55350,10594,2561,70184,13155,4494,1197,3207,90,2,998,567,-310,1257,257
9/27/2020,275213,61813,203014,10386,1692,56413,10915,2350,71370,13265,3874,185,3611,78,13,1063,321,-211,1186,110
9/28/2020,278722,61379,206870,10473,1704,57741,10474,2258,72177,12732,3509,-434,3856,87,12,1328,-441,-92,807,-533
9/29/2020,282724,61686,210437,10601,1718,58865,10659,2067,73309,12726,4002,307,3567,128,14,1124,185,-191,1132,-6
9/30/2020,287008,61321,214947,10740,1731,60320,10353,1964,74368,12317,4284,-365,4510,139,13,1455,-306,-103,1059,-409
10/1/2020,291182,61839,218487,10856,1737,61444,10545,1795,75521,12340,4174,518,3540,116,6,1124,192,-169,1153,23
10/2/2020,295499,63187,221340,10972,1740,62279,10496,2104,76619,12600,4317,1348,2853,116,3,835,-49,309,1098,260
10/3/2020,299506,63399,225052,11055,1743,63286,10652,2103,77784,12755,4007,212,3712,83,3,1007,156,-1,1165,155
10/4/2020,303498,63894,228453,11151,1761,64319,11091,2043,79214,13134,3992,495,3401,96,18,1033,439,-60,1430,379
10/5/2020,307120,63274,232593,11253,1772,65295,10912,2057,80036,12969,3622,-620,4140,102,11,976,-179,14,822,-165
10/6/2020,311176,63365,236437,11374,1806,66315,10787,2135,81043,12922,4056,91,3844,121,34,1020,-125,78,1007,-47
10/7/2020,315714,63951,240291,11472,1819,67310,10807,2447,82383,13254,4538,586,3854,98,13,995,20,312,1340,332
10/8/2020,320564,64924,244060,11580,1838,68352,10717,2485,83392,13202,4850,973,3769,108,19,1042,-90,38,1009,-52
10/9/2020,324658,65314,247667,11677,1860,69203,10746,2555,84364,13301,4094,390,3607,97,22,851,29,70,972,99
10/10/2020,328952,65706,251481,11765,1877,70487,10698,2555,85617,13253,4294,392,3814,88,17,1284,-48,0,1253,-48
10/11/2020,333449,66578,255027,11844,1901,71549,10863,2693,87006,13556,4497,872,3546,79,24,1062,165,138,1389,303
10/12/2020,336716,66262,258519,11935,1922,72633,10814,2805,88174,13619,3267,-316,3492,91,21,1084,-49,112,1168,63
10/13/2020,340622,65299,263296,12027,1944,73733,10908,2643,89228,13551,3906,-963,4777,92,22,1100,94,-162,1054,-68
10/14/2020,344749,64742,267851,12156,1961,74924,10822,2559,90266,13381,4127,-557,4555,129,17,1191,-86,-84,1038,-170
10/15/2020,349160,63231,273661,12268,1984,75974,10636,2743,91337,13379,4411,-1511,5810,112,23,1050,-186,184,1071,-2
10/16/2020,353461,63570,277544,12347,2008,76956,10498,2920,92382,13418,4301,339,3883,79,24,982,-138,177,1045,39
10/17/2020,357762,63739,281592,12431,2032,78062,10591,2671,93356,13262,4301,169,4048,84,24,1106,93,-249,974,-156
10/18/2020,361867,64032,285324,12511,2051,79136,10782,2358,94327,13140,4105,293,3732,80,19,1074,191,-313,971,-122
10/19/2020,365240,63380,289243,12617,2064,80261,10325,2603,95253,12928,3373,-652,3919,106,13,1125,-457,245,926,-212
10/20/2020,368842,62455,293653,12734,2086,81107,10292,2732,96217,13024,3602,-925,4410,117,22,846,-33,129,964,96
10/21/2020,373109,62743,297509,12857,2105,82178,10273,2661,97217,12934,4267,288,3856,123,19,1071,-19,-71,1000,-90
10/22/2020,377541,63576,301006,12959,2120,83338,9980,2768,98206,12748,4432,833,3497,102,15,1160,-293,107,989,-186
10/23/2020,381910,63733,305100,13077,2138,84430,9604,2986,99158,12590,4369,157,4094,118,18,1092,-376,218,952,-158
10/24/2020,385980,63556,309219,13205,2153,85586,9557,2924,100220,12481,4070,-177,4119,128,15,1156,-47,-62,1062,-109
10/25/2020,389712,62649,313764,13299,2164,86815,9151,2861,100991,12012,3732,-907,4545,94,11,1229,-406,-63,771,-469
10/26/2020,392934,61851,317672,13411,2185,87977,8960,2775,101897,11735,3222,-798,3908,112,21,1162,-191,-86,906,-277
10/27/2020,396454,60694,322248,13512,2195,89060,8743,2680,102678,11423,3520,-1157,4576,101,10,1083,-217,-95,781,-312
10/28/2020,400483,61078,325793,13612,2211,90157,8438,2716,103522,11154,4029,384,3545,100,16,1097,-305,36,844,-269
10/29/2020,404048,60569,329778,13701,2225,91235,7951,2824,104235,10775,3565,-509,3985,89,14,1078,-487,108,713,-379
10/30/2020,406945,58868,334295,13782,2239,92312,7457,2839,104847,10296,2897,-1701,4517,81,14,1077,-494,15,612,-479
10/31/2020,410088,58418,337801,13869,2255,94434,6524,2384,105597,8908,3143,-450,3506,87,16,2122,-933,-455,750,-1388
11/1/2020,412784,56899,341942,13943,2273,94819,6935,2178,106205,9113,2696,-1519,4141,74,18,385,411,-206,608,205
11/2/2020,415402,55792,345566,14044,2291,95876,7312,1750,107229,9062,2618,-1107,3624,101,18,1057,377,-428,1024,-51
11/3/2020,418375,54732,349497,14146,2300,96902,6844,1800,107846,8644,2973,-1060,3931,102,9,1026,-468,50,617,-418
11/4/2020,421731,54190,353282,14259,2315,97833,6665,1807,108620,8472,3356,-542,3785,113,15,931,-179,7,774,-172
11/5/2020,425796,54306,357142,14348,2331,98806,6260,2014,109411,8274,4065,116,3860,89,16,973,-405,207,791,-198
11/6/2020,429574,54427,360705,14442,2348,99830,6050,1855,110083,7905,3778,121,3563,94,17,1024,-210,-159,672,-369
11/7/2020,433836,54879,364417,14540,2359,100816,6159,1867,111201,8026,4262,452,3712,98,11,986,109,12,1118,121
11/8/2020,437716,54804,368298,14614,2366,101791,6338,1532,112027,7870,3880,-75,3881,74,7,975,179,-335,826,-156
11/9/2020,440569,53614,372266,14689,2377,102844,6050,1472,112743,7522,2853,-1190,3968,75,11,1053,-288,-60,716,-348
11/10/2020,444348,53846,375741,14761,2391,104144,5724,1497,113756,7221,3779,232,3475,72,14,1300,-326,25,1013,-301
11/11/2020,448118,54300,378982,14836,2403,105117,5161,1662,114343,6823,3770,454,3241,75,12,973,-563,165,587,-398
11/12/2020,452291,55274,382084,14933,2414,106189,4878,1693,115174,6571,4173,974,3102,97,11,1072,-283,31,831,-252
11/13/2020,457735,57604,385094,15037,2428,107147,5028,1604,116207,6632,5444,2330,3010,104,14,958,150,-89,1033,61
11/14/2020,463007,59765,388094,15148,2441,108209,4710,2102,117462,6812,5272,2161,3000,111,13,1062,-318,498,1255,180
11/15/2020,467113,59911,391991,15211,2448,109181,4952,2046,118627,6998,4106,146,3897,63,7,972,242,-56,1165,186
11/16/2020,470648,59909,395443,15296,2455,110221,4420,2537,119633,6957,3535,-2,3452,85,7,1040,-532,491,1006,-41
11/17/2020,474455,60426,398636,15393,2459,111096,4355,2761,120671,7116,3807,517,3193,97,4,875,-65,224,1038,159
11/18/2020,478720,60870,402347,15503,2470,111948,4619,2781,121818,7400,4265,444,3711,110,11,852,264,20,1147,284
11/19/2020,483518,61306,406612,15600,2484,112833,4633,3053,123003,7686,4798,436,4265,97,14,885,14,272,1185,286
11/20/2020,488310,62080,410552,15678,2501,113739,4616,3387,124243,8003,4792,774,3940,78,17,906,-17,334,1240,317
11/21/2020,493308,63579,413955,15774,2515,114863,5323,3121,125822,8444,4998,1499,3403,96,14,1124,707,-266,1579,441
11/22/2020,497668,63596,418188,15884,2531,115939,5529,3165,127164,8694,4360,17,4233,110,16,1076,206,44,1342,250
11/23/2020,502110,63722,422386,16002,2548,117003,5592,3030,128173,8622,4442,126,4198,118,17,1064,63,-135,1009,-72
11/24/2020,506302,64878,425313,16111,2567,118062,5518,3041,129188,8559,4192,1156,2927,109,19,1059,-74,11,1015,-63
11/25/2020,511836,65804,429807,16225,2584,119099,6000,2778,130461,8778,5534,926,4494,114,17,1037,482,-263,1273,219
11/26/2020,516753,66752,433649,16352,2597,120287,5876,2765,131525,8641,4917,948,3842,127,13,1188,-124,-13,1064,-137
11/27/2020,522581,68604,437456,16521,2614,121082,6653,2612,132961,9265,5828,1852,3807,169,17,795,777,-153,1436,624
11/28/2020,527999,69370,441983,16646,2632,122328,6921,2450,134331,9371,5418,766,4527,125,18,1246,268,-162,1370,106
11/29/2020,534266,71658,445793,16815,2652,123163,7608,2339,135762,9947,6267,2288,3810,169,20,835,687,-111,1431,576
11/30/2020,538883,71420,450518,16945,2671,124078,7823,2289,136861,10112,4617,-238,4725,130,19,915,215,-50,1099,165
12/1/2020,543975,72015,454879,17081,2689,125102,7937,2191,137919,10128,5092,595,4361,136,18,1024,114,-98,1058,16
12/2/2020,549508,73429,458880,17199,2710,126163,8202,2010,139085,10212,5533,1414,4001,118,21,1061,265,-181,1166,84
12/3/2020,557877,77969,462553,17355,2734,127136,8155,2213,140238,10368,8369,4540,3673,156,24,973,-47,203,1153,156
12/4/2020,563680,80023,466178,17479,2757,128051,8073,2389,141270,10462,5803,2054,3625,124,23,915,-82,176,1032,94
12/5/2020,569707,81669,470449,17589,2779,129067,8623,2161,142630,10784,6027,1646,4271,110,22,1016,550,-228,1360,322
12/6/2020,575796,83285,474771,17740,2799,130136,8819,2207,143961,11026,6089,1616,4322,151,20,1069,196,46,1331,242
12/7/2020,581550,84481,479202,17867,2823,131071,9473,2060,145427,11533,5754,1196,4431,127,24,935,654,-147,1466,507
12/8/2020,586842,85345,483497,18000,2842,132248,9650,1861,146601,11511,5292,864,4295,133,19,1177,177,-199,1174,-22
12/9/2020,592900,87284,487445,18171,2860,133318,9703,1957,147838,11660,6058,1939,3948,171,18,1070,53,96,1237,149
12/10/2020,598933,88622,491975,18336,2880,134366,9391,2381,149018,11772,6033,1338,4530,165,20,1048,-312,424,1180,112
12/11/2020,605243,89846,496886,18511,2902,135545,9078,2725,150250,11803,6310,1224,4911,175,22,1179,-313,344,1232,31
12/12/2020,611631,91602,501376,18653,2922,136489,8822,2968,151201,11790,6388,1756,4490,142,20,944,-256,243,951,-13
12/13/2020,617820,93165,505836,18819,2941,137605,8679,3274,152499,11953,6189,1563,4460,166,19,1116,-143,306,1298,163
12/14/2020,623309,93396,510957,18956,2963,138988,8994,3120,154065,12114,5489,231,5121,137,22,1383,315,-154,1566,161
12/15/2020,629429,93662,516656,19111,2990,140225,8643,3264,155122,11907,6120,266,5699,155,27,1237,-351,144,1057,-207
12/16/2020,636154,94922,521984,19248,3010,141365,8263,3705,156343,11968,6725,1260,5328,137,20,1140,-380,441,1221,61
12/17/2020,643508,97139,526979,19390,3027,142741,7851,4414,158033,12265,7354,2217,4995,142,17,1376,-412,709,1690,297
12/18/2020,650197,98688,531995,19514,3048,143959,7673,4940,159620,12613,6689,1549,5016,124,21,1218,-178,526,1587,348
12/19/2020,657948,102029,536260,19659,3068,145066,8112,5273,161519,13385,7751,3341,4265,145,20,1107,439,333,1899,772
12/20/2020,664930,103239,541811,19880,3087,146958,8057,5009,163111,13066,6982,1210,5551,221,19,1892,-55,-264,1592,-319
12/21/2020,671778,104809,546884,20085,3097,148308,8366,4806,164577,13172,6848,1570,5073,205,10,1350,309,-203,1466,106
12/22/2020,678125,105146,552722,20257,3115,149691,8620,4462,165888,13082,6347,337,5838,172,18,1383,254,-344,1311,-90
12/23/2020,685639,106528,558703,20408,3130,151122,8643,4947,167842,13590,7514,1382,5981,151,15,1431,23,485,1954,508
12/24/2020,692838,108269,563980,20589,3146,152491,8833,5305,169775,14138,7199,1741,5277,181,16,1369,190,358,1933,548
12/25/2020,700097,108946,570304,20847,3167,154242,8720,5742,171871,14462,7259,677,6324,258,21,1751,-113,437,2096,324
12/26/2020,706837,109150,576693,20994,3182,156798,9439,4510,173929,13949,6740,204,6389,147,15,2556,719,-1232,2058,-513
12/27/2020,713365,108452,583676,21237,3204,158615,9655,4452,175926,14107,6528,-698,6983,243,22,1817,216,-58,1997,158
12/28/2020,719219,107789,589978,21452,3226,159878,9919,4581,177604,14500,5854,-663,6302,215,22,1263,264,129,1678,393
12/29/2020,727122,108636,596783,21703,3246,161337,10018,5059,179660,15077,7903,847,6805,251,20,1459,99,478,2056,577
12/30/2020,735124,109439,603741,21944,3266,162911,9882,5654,181713,15536,8002,803,6958,241,20,1574,-136,595,2053,459
12/31/2020,743198,109963,611097,22138,3287,164881,9746,5821,183735,15567,8074,524,7356,194,21,1970,-136,167,2022,31
1/1/2021,751270,111005,617936,22329,3308,166512,10082,5789,185691,15871,8072,1042,6839,191,21,1631,336,-32,1956,304
1/2/2021,758473,110400,625518,22555,3334,168781,10872,4599,187586,15471,7203,-605,7582,226,26,2269,790,-1190,1895,-400
1/3/2021,765350,110679,631937,22734,3345,170510,10978,4410,189243,15388,6877,279,6419,179,11,1729,106,-189,1657,-83
1/4/2021,772103,110089,639103,22911,3369,173036,10371,4299,191075,14670,6753,-590,7166,177,24,2526,-607,-111,1832,-718
1/5/2021,779548,110693,645746,23109,3392,174131,10897,4479,192899,15376,7445,604,6643,198,23,1095,526,180,1824,706
1/6/2021,788402,112593,652513,23296,3410,175441,12196,4254,195301,16450,8854,1900,6767,187,18,1310,1299,-225,2402,1074
1/7/2021,797723,114766,659437,23520,3435,176882,12781,4601,197699,17382,9321,2173,6924,224,25,1441,585,347,2398,932
1/8/2021,808340,117704,666883,23753,3463,179562,13397,4236,200658,17633,10617,2938,7446,233,28,2680,616,-365,2959,251
1/9/2021,818386,120928,673511,23947,3485,181613,13076,5237,203411,18313,10046,3224,6628,194,22,2051,-321,1001,2753,680
1/10/2021,828026,122873,681024,24129,3517,184576,13166,4863,206122,18029,9640,1945,7513,182,32,2963,90,-374,2711,-284
1/11/2021,836718,123636,688739,24343,3551,187086,13541,4405,208583,17946,8692,763,7715,214,34,2510,375,-458,2461,-83
1/12/2021,846765,126313,695807,24645,3589,188675,14591,4397,211252,18988,10047,2677,7068,302,38,1589,1050,-8,2669,1042
1/13/2021,858043,129628,703464,24951,3634,191635,15009,4450,214728,19459,11278,3315,7657,306,45,2960,418,53,3476,471
1/14/2021,869600,133149,711205,25246,3675,193719,15852,4647,217893,20499,11557,3521,7741,295,41,2084,843,197,3165,1040
1/15/2021,882418,138238,718696,25484,3710,195924,15553,5247,220434,20800,12818,5089,7491,238,35,2205,-299,600,2541,301
1/16/2021,896642,143517,727358,25767,3745,198136,17524,4565,223970,22089,14224,5279,8662,283,35,2212,1971,-682,3536,1289
1/17/2021,907929,145482,736460,25987,3779,201907,16741,4938,227365,21679,11287,1965,9102,220,34,3771,-783,373,3395,-410
1/18/2021,917015,144798,745935,26282,3815,204711,16419,4781,229726,21200,9086,-684,9475,295,36,2804,-322,-157,2361,-479
1/19/2021,927380,146842,753948,26590,3836,209238,14604,4611,232289,19215,10365,2044,8013,308,21,4527,-1815,-170,2563,-1985
1/20/2021,939948,149388,763703,26857,3868,210983,16389,4835,236075,21224,12568,2546,9755,267,32,1745,1785,224,3786,2009
1/21/2021,951651,151658,772790,27203,3900,213570,16966,4790,239226,21756,11703,2270,9087,346,32,2587,577,-45,3151,532
1/22/2021,965283,156683,781147,27453,3940,215719,17752,5607,243018,23359,13632,5025,8357,250,40,2149,786,817,3792,1603
1/23/2021,977474,158751,791059,27664,3980,219287,18657,4379,246303,23036,12191,2068,9912,211,40,3568,905,-1228,3285,-323
1/24/2021,989262,162617,798810,27835,4024,221567,19554,4670,249815,24224,11788,3866,7751,171,44,2280,897,291,3512,1188
1/25/2021,999256,161636,809488,28132,4063,224071,19869,4263,252266,24132,9994,-981,10678,297,39,2504,315,-407,2451,-92
1/26/2021,1012350,163526,820356,28468,4108,227010,19432,4030,254580,23462,13094,1890,10868,336,45,2939,-437,-233,2314,-670
1/27/2021,1024298,164113,831330,28855,4134,229981,18528,3773,256416,22301,11948,587,10974,387,26,2971,-904,-257,1836,-1161
1/28/2021,1037993,166540,842122,29331,4185,232701,18473,3946,259305,22419,13695,2427,10792,476,51,2720,-55,173,2889,118
1/29/2021,1051795,170017,852260,29518,4224,235140,19381,4008,262753,23389,13802,3477,10138,187,39,2439,908,62,3448,970
1/30/2021,1066313,174083,862502,29728,4254,238395,20539,3056,266244,23595,14518,4066,10242,210,30,3255,1158,-952,3491,206
1/31/2021,1078314,175095,873221,29998,4267,242069,19272,4110,269718,23382,12001,1012,10719,270,13,3674,-1267,1054,3474,-213
2/1/2021,1089308,175349,883682,30277,4337,244202,19824,4969,273332,24793,10994,254,10461,279,70,2133,552,859,3614,1411
2/2/2021,1099687,172576,896530,30581,4379,248515,18925,4875,276694,23800,10379,-2773,12848,304,42,4313,-899,-94,3362,-993
2/3/2021,1111671,175236,905665,30770,4420,249810,21863,4168,280261,26031,11984,2660,9135,189,41,1295,2938,-707,3567,2231
2/4/2021,1123105,175068,917036,31001,4461,254155,20419,4858,283893,25277,11434,-168,11371,231,41,4345,-1444,690,3632,-754
2/5/2021,1134854,176672,926980,31202,4502,256702,21191,4838,287233,26029,11749,1604,9944,201,41,2547,772,-20,3340,752
2/6/2021,1147010,176433,939184,31393,4541,261027,19325,4719,289612,24044,12156,-239,12204,191,39,4325,-1866,-119,2379,-1985
2/7/2021,1157837,176291,949990,31556,4587,265369,17958,5911,293825,23869,10827,-142,10806,163,46,4342,-1367,1192,4213,-175
2/8/2021,1166079,171288,963028,31763,4631,268785,17766,5787,296969,23553,8242,-5003,13038,207,44,3416,-192,-124,3144,-316
2/9/2021,1174779,169351,973452,31976,4681,271573,18174,5978,300406,24152,8700,-1937,10424,213,50,2788,408,191,3437,599
2/10/2021,1183555,168416,982972,32167,4725,274817,16676,7497,303715,24173,8776,-935,9520,191,44,3244,-1498,1519,3309,21
2/11/2021,1191990,166492,993117,32381,4748,278822,14119,8540,306229,22659,8435,-1924,10145,214,23,4005,-2557,1043,2514,-1514
2/12/2021,1201859,165086,1004117,32656,4798,284579,10774,9888,310039,20662,9869,-1406,11000,275,50,5757,-3345,1348,3810,-1997
2/13/2021,1210703,161731,1016036,32936,4850,289189,9644,9374,313057,19018,8844,-3355,11919,280,52,4610,-1130,-514,3018,-1644
2/14/2021,1217468,159012,1025273,33183,4895,293538,9017,8103,315553,17120,6765,-2719,9237,247,45,4349,-627,-1271,2496,-1898
2/15/2021,1223930,158498,1032065,33367,4940,295623,8881,7988,317432,16869,6462,-514,6792,184,45,2085,-136,-115,1879,-251
2/16/2021,1233959,160689,1039674,33596,4987,297695,9042,7569,319293,16611,10029,2191,7609,229,47,2072,161,-419,1861,-258
2/17/2021,1243646,162182,1047676,33788,5026,299795,8467,7450,320738,15917,9687,1493,8002,192,39,2100,-575,-119,1445,-694
2/18/2021,1252685,160494,1058222,33969,5044,302451,7067,6549,321111,13616,9039,-1688,10546,181,18,2656,-1400,-901,373,-2301
2/19/2021,1263299,160142,1069005,34152,5081,304995,7323,5632,323031,12955,10614,-352,10783,183,37,2544,256,-917,1920,-661
2/20/2021,1271353,158197,1078840,34316,5121,307759,7165,5858,325903,13023,8054,-1945,9835,164,40,2764,-158,226,2872,68
2/21/2021,1278653,157088,1087076,34489,5172,310412,7137,5902,328623,13039,7300,-1109,8236,173,51,2653,-28,44,2720,16
2/22/2021,1288833,157148,1096994,34691,5206,312748,7528,5612,331094,13140,10180,60,9918,202,34,2336,391,-290,2471,101
2/23/2021,1298608,158604,1104990,35014,5248,314563,7126,4939,331876,12065,9775,1456,7996,323,42,1815,-402,-673,782,-1075
2/24/2021,1306141,158162,1112725,35254,5301,317003,6008,4346,332658,10354,7533,-442,7735,240,53,2440,-1118,-593,782,-1711
2/25/2021,1314634,157705,1121411,35518,5346,319326,5499,4068,334239,9567,8493,-457,8686,264,45,2323,-509,-278,1581,-787
2/26/2021,1322866,158408,1128672,35786,5385,321038,5560,3917,335900,9477,8232,703,7261,268,39,1712,61,-151,1661,-90
2/27/2021,1329074,157039,1136054,35981,5439,322285,5885,4028,337637,9913,6208,-1369,7382,195,54,1247,325,111,1737,436
2/28/2021,1334634,155765,1142703,36166,5478,323892,5940,4425,339735,10365,5560,-1274,6649,185,39,1607,55,397,2098,452
3/1/2021,1341314,153074,1151915,36325,5528,326509,5891,3865,341793,9756,6680,-2691,9212,159,50,2617,-49,-560,2058,-609
3/2/2021,1347026,149645,1160863,36518,5568,328526,5072,3205,342371,8277,5712,-3429,8948,193,40,2017,-819,-660,578,-1479
3/3/2021,1353834,147197,1169916,36721,5613,331016,3742,3437,343808,7179,6808,-2448,9053,203,45,2490,-1330,232,1437,-1098
3/4/2021,1361098,147845,1176356,36897,5657,332758,3940,3461,345816,7401,7264,648,6440,176,44,1742,198,24,2008,222
3/5/2021,1368093,148380,1182687,37026,5702,334100,4026,3147,346975,7173,6995,535,6331,129,45,1342,86,-314,1159,-228
3/6/2021,1373836,147172,1189510,37154,5748,335617,4228,2998,348591,7226,5743,-1208,6823,128,46,1517,202,-149,1616,53
3/7/2021,1379662,147740,1194656,37266,5790,337426,4194,3015,350425,7209,5826,568,5146,112,42,1809,-34,17,1834,-17
3/8/2021,1386556,145628,1203381,37547,5838,338931,4494,2945,352208,7439,6894,-2112,8725,281,48,1505,300,-70,1783,230
3/9/2021,1392945,144311,1210877,37757,5883,340587,3856,2749,353075,6605,6389,-1317,7496,210,45,1656,-638,-196,867,-834
3/10/2021,1398578,144213,1216433,37932,5923,341398,3691,3103,354115,6794,5633,-98,5556,175,40,811,-165,354,1040,189
3/11/2021,1403722,141070,1224603,38049,5943,342306,4253,3367,355869,7620,5144,-3143,8170,117,20,908,562,264,1754,826
3/12/2021,1410134,140451,1231454,38229,5969,343351,4670,3752,357742,8422,6412,-619,6851,180,26,1045,417,385,1873,802
3/13/2021,1414741,138942,1237470,38329,5991,345202,4226,3357,358776,7583,4607,-1509,6016,100,22,1851,-444,-395,1034,-839
3/14/2021,1419455,137912,1243117,38426,6026,347210,3443,3301,359980,6744,4714,-1030,5647,97,35,2008,-783,-56,1204,-839
3/15/2021,1425044,136524,1249947,38573,6038,349002,3485,3010,361535,6495,5589,-1388,6830,147,12,1792,42,-291,1555,-249
3/16/2021,1430458,134042,1257663,38753,6062,350561,2996,2751,362370,5747,5414,-2482,7716,180,24,1559,-489,-259,835,-748
3/17/2021,1437283,131695,1266673,38915,6077,351680,2907,3036,363700,5943,6825,-2347,9010,162,15,1119,-89,285,1330,196
3/18/2021,1443853,131753,1272958,39142,6100,352827,3273,3219,365419,6492,6570,58,6285,227,23,1147,366,183,1719,549
3/19/2021,1450132,131828,1278965,39339,6120,354036,3483,3368,367007,6851,6279,75,6007,197,20,1209,210,149,1588,359
3/20/2021,1455788,131616,1284725,39447,6143,355221,3894,3686,368944,7580,5656,-212,5760,108,23,1185,411,318,1937,729
3/21/2021,1460184,129844,1290790,39550,6160,357100,3859,3463,370582,7322,4396,-1772,6065,103,17,1879,-35,-223,1638,-258
3/22/2021,1465928,128250,1297967,39711,6179,358826,3775,3276,372056,7051,5744,-1594,7177,161,19,1726,-84,-187,1474,-271
3/23/2021,1471225,126439,1304921,39865,6206,360479,3107,3079,372871,6186,5297,-1811,6954,154,27,1653,-668,-197,815,-865
3/24/2021,1476452,123926,1312543,39983,6224,362248,2650,2639,373761,5289,5227,-2513,7622,118,18,1769,-457,-440,890,-897
3/25/2021,1482559,125279,1317199,40081,6241,362975,3222,3049,375487,6271,6107,1353,4656,98,17,727,572,410,1726,982
3/26/2021,1487541,124497,1322878,40166,6260,363599,3629,3380,376868,7009,4982,-782,5679,85,19,624,407,331,1381,738
3/27/2021,1492002,124517,1327121,40364,6281,364251,3932,3758,378222,7690,4461,20,4243,198,21,652,303,378,1354,681
3/28/2021,1496085,124236,1331400,40449,6304,365592,3966,3830,379692,7796,4083,-281,4279,85,23,1341,34,72,1470,106
3/29/2021,1501093,123694,1336818,40581,6324,366615,4034,3733,380706,7767,5008,-542,5418,132,20,1023,68,-97,1014,-29
3/30/2021,1505775,122326,1342695,40754,6327,367819,3419,3525,381090,6944,4682,-1368,5877,173,3,1204,-615,-208,384,-823
3/31/2021,1511712,122524,1348330,40858,6341,369007,3028,3679,382055,6707,5937,198,5635,104,14,1188,-391,154,965,-237
4/1/2021,1517854,121222,1355578,41054,6344,369929,3447,3672,383392,7119,6142,-1302,7248,196,3,922,419,-7,1337,412
4/2/2021,1523179,121011,1361017,41151,6351,371254,3433,3594,384632,7027,5325,-211,5439,97,7,1325,-14,-78,1240,-92
4/3/2021,1527524,120068,1366214,41242,6356,372494,3317,3563,385730,6880,4345,-943,5197,91,5,1240,-116,-31,1098,-147
4/4/2021,1534255,116709,1375877,41669,6360,373565,3149,3392,386466,6541,6731,-3359,9663,427,4,1071,-168,-171,736,-339
4/5/2021,1537967,114475,1381677,41815,6372,374542,2771,3304,386989,6075,3712,-2234,5800,146,12,977,-378,-88,523,-466
4/6/2021,1542516,114566,1385973,41977,6379,375080,2705,3312,387476,6017,4549,91,4296,162,7,538,-66,8,487,-58
4/7/2021,1547376,113570,1391742,42064,6391,375651,2814,3482,388338,6296,4860,-996,5769,87,12,571,109,170,862,279
4/8/2021,1552880,111271,1399382,42227,6410,376270,3244,3653,389577,6897,5504,-2299,7640,163,19,619,430,171,1239,601
4/9/2021,1558145,110118,1405679,42348,6424,376959,3506,3701,390590,7207,5265,-1153,6297,121,14,689,262,48,1013,310
4/10/2021,1562868,111137,1409288,42443,6435,377797,3716,3619,391567,7335,4723,1019,3609,95,11,838,210,-82,977,128
4/11/2021,1566995,109958,1414507,42530,6450,379210,3617,3321,392598,6938,4127,-1179,5219,87,15,1413,-99,-298,1031,-397
4/12/2021,1571824,109372,1419796,42656,6459,380560,3324,2947,393290,6271,4829,-586,5289,126,9,1350,-293,-374,692,-667
4/13/2021,1577526,108599,1426145,42782,6482,381449,3326,2861,394118,6187,5702,-773,6349,126,23,889,2,-86,828,-84
4/14/2021,1583182,108384,1431892,42906,6489,382091,3338,2861,394779,6199,5656,-215,5747,124,7,642,12,0,661,12
4/15/2021,1589359,108032,1438254,43073,6504,382617,3921,3067,396109,6988,6177,-352,6362,167,15,526,583,206,1330,789
4/16/2021,1594722,107297,1444229,43196,6513,383655,3607,3313,397088,6920,5363,-735,5975,123,9,1038,-314,246,979,-68
4/17/2021,1599763,106243,1450192,43328,6520,384652,3512,3441,398125,6953,5041,-1054,5963,132,7,997,-95,128,1037,33
4/18/2021,1604348,105859,1455065,43424,6536,385615,3313,3611,399075,6924,4585,-384,4873,96,16,963,-199,170,950,-29
4/19/2021,1609300,104319,1461414,43567,6558,386606,3218,3666,400048,6884,4952,-1540,6349,143,22,991,-95,55,973,-40
4/20/2021,1614849,102930,1468142,43777,6569,387507,2945,3487,400508,6432,5549,-1389,6728,210,11,901,-273,-179,460,-452
4/21/2021,1620569,101106,1475456,44007,6587,388083,2954,3486,401110,6440,5720,-1824,7314,230,18,576,9,-1,602,8
4/22/2021,1626812,101191,1481449,44172,6596,388735,3497,3548,402376,7045,6243,85,5993,165,9,652,543,62,1266,605
4/23/2021,1632248,100533,1487369,44346,6612,389445,3584,3619,403260,7203,5436,-658,5920,174,16,710,87,71,884,158
4/24/2021,1636792,99970,1492322,44500,6623,390334,3563,3647,404167,7210,4544,-563,4953,154,11,889,-21,28,907,7
4/25/2021,1641194,100474,1496126,44594,6645,391301,3399,3718,405063,7117,4402,504,3804,94,22,967,-164,71,896,-93
4/26/2021,1647138,100652,1501715,44770,6660,392595,3152,3405,405812,6557,5944,178,5589,176,15,1294,-247,-313,749,-560
4/27/2021,1651794,100256,1506599,44939,6679,393205,2999,3322,406205,6321,4656,-396,4884,169,19,610,-153,-83,393,-236
4/28/2021,1657035,100502,1511417,45116,6690,393814,2950,3390,406844,6340,5241,246,4818,177,11,609,-49,68,639,19
4/29/2021,1662868,100102,1517432,45334,6710,394403,3308,3410,407831,6718,5833,-400,6015,218,20,589,358,20,987,378
4/30/2021,1668368,100213,1522634,45521,6733,394939,3421,3527,408620,6948,5500,111,5202,187,23,536,113,117,789,230
5/1/2021,1672880,100250,1526978,45652,6747,395644,3533,3622,409546,7155,4512,37,4344,131,14,705,112,95,926,207
5/2/2021,1677274,100760,1530718,45796,6767,396594,3450,3589,410400,7039,4394,510,3740,144,20,950,-83,-33,854,-116
5/3/2021,1682004,100564,1535491,45949,6788,397349,3483,3537,411157,7020,4730,-196,4773,153,21,755,33,-52,757,-19
5/4/2021,1686373,99087,1541149,46137,6807,397955,3247,3564,411573,6811,4369,-1477,5658,188,19,606,-236,27,416,-209
5/5/2021,1691658,98217,1547092,46349,6830,398610,3240,3738,412418,6978,5285,-870,5943,212,23,655,-7,174,845,167
5/6/2021,1697305,98277,1552532,46496,6850,399224,3406,3843,413323,7249,5647,60,5440,147,20,614,166,105,905,271
5/7/2021,1703632,98546,1558423,46663,6872,399821,3485,3928,414106,7413,6327,269,5891,167,22,597,79,85,783,164
5/8/2021,1709762,99003,1563917,46842,6896,400403,3569,3970,414838,7539,6130,457,5494,179,24,582,84,42,732,126
5/9/2021,1713684,98395,1568277,47012,6911,401114,3648,3974,415647,7622,3922,-608,4360,170,15,711,79,4,809,83
5/10/2021,1718575,96742,1574615,47218,6933,401744,3723,3941,416341,7664,4891,-1653,6338,206,22,630,75,-33,694,42
5/11/2021,1723596,95924,1580207,47465,6952,402374,3490,3931,416747,7421,5021,-818,5592,247,19,630,-233,-10,406,-243
5/12/2021,1728204,95709,1584878,47617,6973,403039,3402,3989,417403,7391,4608,-215,4671,152,21,665,-88,58,656,-30
5/13/2021,1731652,94857,1589079,47716,6973,403630,3630,3955,418188,7585,3448,-852,4201,99,0,591,228,-34,785,194
5/14/2021,1734285,93576,1592886,47823,7003,404187,3502,4128,418820,7630,2633,-1281,3807,107,30,557,-128,173,632,45
5/15/2021,1736670,91636,1597067,47967,7066,404715,3288,3978,419047,7266,2385,-1940,4181,144,63,528,-214,-150,227,-364
5/16/2021,1739750,90800,1600857,48093,7082,404980,3189,3957,419208,7146,3080,-836,3790,126,16,265,-99,-21,161,-120
5/17/2021,1744045,89129,1606611,48305,7107,405229,3158,4135,419629,7293,4295,-1671,5754,212,25,249,-31,178,421,147
5/18/2021,1748230,87514,1612239,48477,7130,405357,3248,4185,419920,7433,4185,-1615,5628,172,23,128,90,50,291,140
5/19/2021,1753101,87829,1616603,48669,7149,405535,3366,4409,420459,7775,4871,315,4364,192,19,178,118,224,539,342
5/20/2021,1758898,88439,1621572,48887,7169,405714,3797,4674,421354,8471,5797,610,4969,218,20,179,431,265,895,696
5/21/2021,1764644,89429,1626142,49073,7184,405918,4142,4966,422210,9108,5746,990,4570,186,15,204,345,292,856,637
5/22/2021,1769940,91240,1629495,49205,7196,406300,4386,5260,423142,9646,5296,1811,3353,132,12,382,244,294,932,538
5/23/2021,1775220,92847,1633045,49328,7207,406669,4744,5389,424009,10133,5280,1607,3550,123,11,369,358,129,867,487
5/24/2021,1781127,93393,1638279,49455,7225,406987,5079,5537,424828,10616,5907,546,5234,127,18,318,335,148,819,483
5/25/2021,1786187,94486,1642074,49627,7239,407493,5017,5463,425212,10480,5060,1093,3795,172,14,506,-62,-74,384,-136
5/26/2021,1791221,96187,1645263,49771,7250,408019,4993,5567,425829,10560,5034,1701,3189,144,11,526,-24,104,617,80
5/27/2021,1797499,98405,1649187,49907,7271,408585,5280,5633,426769,10913,6278,2218,3924,136,21,566,287,66,940,353
5/28/2021,1803361,98704,1654557,50100,7288,409497,5161,5516,427462,10677,5862,299,5370,193,17,912,-119,-117,693,-236
5/29/2021,1809926,99690,1659974,50262,7296,410508,5004,5461,428269,10465,6565,986,5417,162,8,1011,-157,-55,807,-212
5/30/2021,1816041,101639,1663998,50404,7309,411495,5100,5429,429333,10529,6115,1949,4024,142,13,987,96,-32,1064,64
5/31/2021,1821703,102006,1669119,50578,7327,412074,5241,5417,430059,10658,5662,367,5121,174,18,579,141,-12,726,129
6/1/2021,1826527,101325,1674479,50723,7349,412593,5214,5422,430578,10636,4824,-681,5360,145,22,519,-27,5,519,-22
6/2/2021,1831773,100364,1680501,50908,7361,413179,5178,5461,431179,10639,5246,-961,6022,185,12,586,-36,39,601,3
6/3/2021,1837126,94438,1691593,51095,7381,413680,5402,5430,431893,10832,5353,-5926,11092,187,20,501,224,-31,714,193
6/4/2021,1843612,94773,1697543,51296,7402,414496,5414,5487,432799,10901,6486,335,5950,201,21,816,12,57,906,69
6/5/2021,1850206,96973,1701784,51449,7423,415317,5756,5620,434116,11376,6594,2200,4241,153,21,821,342,133,1317,475
6/6/2021,1856038,98455,1705971,51612,7438,416181,5966,5550,435135,11516,5832,1482,4187,163,15,864,210,-70,1019,140
6/7/2021,1863031,99663,1711565,51803,7457,416994,6261,5620,436332,11881,6993,1208,5594,191,19,813,295,70,1197,365
6/8/2021,1869325,99963,1717370,51992,7478,417997,6057,5555,437087,11612,6294,300,5805,189,21,1003,-204,-65,755,-269
6/9/2021,1877050,101635,1723253,52162,7499,419109,6120,5730,438458,11850,7725,1672,5883,170,21,1112,63,175,1371,238
6/10/2021,1885901,104614,1728914,52373,7523,420211,6991,5829,440554,12820,8851,2979,5661,211,24,1102,871,99,2096,970
6/11/2021,1894025,106315,1735144,52566,7543,421396,7750,6158,442847,13908,8124,1701,6230,193,20,1185,759,329,2293,1088
6/12/2021,1901490,108324,1740436,52730,7557,422121,8855,6769,445302,15624,7465,2009,5292,164,14,725,1105,611,2455,1716
6/13/2021,1911358,113388,1745091,52879,7571,423056,10034,7410,448071,17444,9868,5064,4655,149,14,935,1179,641,2769,1820
6/14/2021,1919547,115197,1751234,53116,7609,424088,11240,7856,450793,19096,8189,1809,6143,237,38,1032,1206,446,2722,1652
6/15/2021,1927708,116787,1757641,53280,7634,425417,11102,8142,452295,19244,8161,1590,6407,164,25,1329,-138,286,1502,148
6/16/2021,1937652,120306,1763870,53476,7665,426695,11555,8756,454671,20311,9944,3519,6229,196,31,1278,453,614,2376,1067
6/17/2021,1950276,125303,1771220,53753,7713,428764,13054,9284,458815,22338,12624,4997,7350,277,48,2069,1499,528,4144,2027
6/18/2021,1963266,130096,1779127,54043,7777,431264,14951,9560,463552,24511,12990,4793,7907,290,64,2500,1897,276,4737,2173
6/19/2021,1976172,135738,1786143,54291,7836,433499,16787,10325,468447,27112,12906,5642,7016,248,59,2235,1836,765,4895,2601
6/20/2021,1989909,142719,1792528,54662,7905,435982,19105,11037,474029,30142,13737,6981,6385,371,69,2483,2318,712,5582,3030
6/21/2021,2004445,147728,1801761,54956,7976,439007,20717,11343,479043,32060,14536,5009,9233,294,71,3025,1612,306,5014,1918
6/22/2021,2018113,152686,1810136,55291,8014,442059,21167,11024,482264,32191,13668,4958,8375,335,38,3052,450,-319,3221,131
6/23/2021,2033421,160524,1817303,55594,8057,443195,22868,12837,486957,35705,15308,7838,7167,303,43,1136,1701,1813,4693,3514
6/24/2021,2053995,171542,1826504,55949,8107,445718,26403,14234,494462,40637,20574,11018,9201,355,50,2523,3535,1397,7505,4932
6/25/2021,2072867,181435,1835061,56371,8177,448288,29325,15606,501396,44931,18872,9893,8557,422,70,2570,2922,1372,6934,4294
6/26/2021,2093962,194776,1842457,56729,8220,451013,33829,17605,510667,51434,21095,13341,7396,358,43,2725,4504,1999,9271,6503
6/27/2021,2115304,207685,1850481,57138,8269,454497,38464,18831,520061,57295,21342,12909,8024,409,49,3484,4635,1226,9394,5861
6/28/2021,2135998,218476,1859961,57561,8348,457935,42252,19874,528409,62126,20694,10791,9480,423,79,3438,3788,1043,8348,4831
6/29/2021,2156465,228835,1869606,58024,8426,461439,45504,20419,535788,65923,20467,10359,9645,463,78,3504,3252,545,7379,3797
6/30/2021,2178272,239368,1880413,58491,8486,464943,47829,22210,543468,70039,21807,10533,10807,467,60,3504,2325,1791,7680,4116
7/1/2021,2203108,253826,1890287,58995,8528,468461,49836,24184,551009,74020,24836,14458,9874,504,42,3518,2007,1974,7541,3981
7/2/2021,2228938,267539,1901865,59534,8547,473467,53014,25380,560408,78394,25830,13713,11578,539,19,5006,3178,1196,9399,4374
7/3/2021,2256851,281677,1915147,60027,8577,479150,54941,27442,570110,82383,27913,14138,13282,493,30,5683,1927,2062,9702,3989
7/4/2021,2284084,295228,1928274,60582,8652,484949,59307,27687,580595,86994,27233,13551,13127,555,75,5799,4366,245,10485,4611
7/5/2021,2313829,309999,1942690,61140,8779,491556,62873,28290,591498,91163,29745,14771,14416,558,127,6607,3566,603,10903,4169
7/6/2021,2345018,324597,1958553,61868,8861,497492,65448,29136,600937,94584,31189,14598,15863,728,82,5936,2575,846,9439,3421
7/7/2021,2379397,343101,1973388,62908,9042,501199,69644,30418,610303,100062,34379,18504,14835,1040,181,3707,4196,1282,9366,5478
7/8/2021,2417788,359455,1994573,63760,9110,512085,72361,29721,623277,102082,38391,16354,21185,852,68,10886,2717,-697,12974,2020
7/9/2021,2455912,367733,2023548,64631,9306,526941,73239,26903,636389,100142,38124,8278,28975,871,196,14856,878,-2818,13112,-1940
7/10/2021,2491006,373440,2052109,65457,9357,543867,71812,24273,649309,96085,35094,5707,28561,826,51,16926,-1427,-2630,12920,-4057
7/11/2021,2527203,376015,2084724,66464,9395,564437,68251,20359,662442,88610,36197,2575,32615,1007,38,20570,-3561,-3914,13133,-7475
7/12/2021,2567630,380797,2119478,67355,9462,584912,66581,16106,677061,82687,40427,4782,34754,891,67,20475,-1670,-4253,14619,-5923
7/13/2021,2615529,407709,2139601,68219,9541,589486,71848,18368,689243,90216,47899,26912,20123,864,79,4574,5267,2262,12182,7529
7/14/2021,2670046,443473,2157363,69210,9603,592556,78571,21180,701910,99751,54517,35764,17762,991,62,3070,6723,2812,12667,9535
7/15/2021,2726803,480199,2176412,70192,9743,595582,86298,22978,714601,109276,56757,36726,19049,982,140,3026,7727,1798,12691,9525
7/16/2021,2780803,504915,2204491,71397,9845,604033,88295,24843,727016,113138,54000,24716,28079,1205,102,8451,1997,1865,12415,3862
7/17/2021,2832755,527872,2232394,72489,9902,615640,87929,23713,737184,111642,51952,22957,27903,1092,57,11607,-366,-1130,10168,-1496
7/18/2021,2877476,542236,2261658,73582,10103,627481,86457,22271,746312,108728,44721,14364,29264,1093,201,11841,-1472,-1442,9128,-2914
7/19/2021,2911733,542938,2293875,74920,10345,640171,81275,19521,751312,100796,34257,702,32217,1338,242,12690,-5182,-2750,5000,-7932
7/20/2021,2950058,550192,2323666,76200,10610,652242,75776,18897,757525,94673,38325,7254,29791,1280,265,12071,-5499,-624,6213,-6123
7/21/2021,2983830,549694,2356553,77583,10692,662800,72115,17822,763429,89937,33772,-498,32887,1383,82,10558,-3661,-1075,5904,-4736
7/22/2021,3033339,561384,2392923,79032,10865,673424,68974,17224,770487,86198,49509,11690,36370,1449,173,10624,-3141,-598,7058,-3739
7/23/2021,3082410,569901,2431911,80598,11021,687864,62789,16846,778520,79635,49071,8517,38988,1566,156,14440,-6185,-378,8033,-6563
7/24/2021,3127826,574135,2471678,82013,11181,702477,56946,16276,786880,73222,45416,4234,39767,1415,160,14613,-5843,-570,8360,-6413
7/25/2021,3166505,573908,2509318,83279,11333,716838,48934,15168,792273,64102,38679,-227,37640,1266,152,14361,-8012,-1108,5393,-9120
7/26/2021,3194733,560275,2549692,84766,11436,731504,38271,13724,794935,51995,28228,-13633,40374,1487,103,14666,-10663,-1444,2662,-12107
7/27/2021,3239936,556281,2596820,86835,11606,746087,26961,13848,798502,40809,45203,-3994,47128,2069,170,14583,-11310,124,3567,-11186
7/28/2021,3287727,558392,2640676,88659,11688,757122,22332,12885,804027,35217,47791,2111,43856,1824,82,11035,-4629,-963,5525,-5592
7/29/2021,3331206,554484,2686170,90552,11844,768562,16676,10790,807872,27466,43479,-3908,45494,1893,156,11440,-5656,-2095,3845,-7751
7/30/2021,3372374,549343,2730720,92311,11952,779720,11264,8390,811326,19654,41168,-5141,44550,1759,108,11158,-5412,-2400,3454,-7812
7/31/2021,3409658,545447,2770092,94119,12135,784668,10134,7716,814653,17850,37284,-3896,39372,1808,183,4948,-1130,-674,3327,-1804
8/1/2021,3440396,535135,2809538,95723,12209,789261,9399,6485,817354,15884,30738,-10312,39446,1604,74,4593,-735,-1231,2701,-1966
8/2/2021,3462800,523164,2842345,97291,12363,791422,9202,5777,818764,14979,22404,-11971,32807,1568,154,2161,-197,-708,1410,-905
8/3/2021,3496700,524142,2873669,98889,12433,793928,8705,5299,820365,14004,33900,978,31324,1598,70,2506,-497,-478,1601,-975
8/4/2021,3532567,524011,2907920,100636,12514,796381,9535,4916,823346,14451,35867,-131,34251,1747,81,2453,830,-383,2981,447
8/5/2021,3568331,518310,2947646,102375,12629,799151,9458,4419,825657,13877,35764,-5701,39726,1739,115,2770,-77,-497,2311,-574
8/6/2021,3607863,507375,2996478,104010,12682,802373,8813,3974,827842,12787,39532,-10935,48832,1635,53,3222,-645,-445,2185,-1090
8/7/2021,3639616,497824,3036194,105598,12750,806924,6957,3219,829850,10176,31753,-9551,39716,1588,68,4551,-1856,-755,2008,-2611
8/8/2021,3666031,474233,3084702,107096,12770,808087,7567,3075,831499,10642,26415,-23591,48508,1498,20,1163,610,-144,1649,466
8/9/2021,3686740,448508,3129661,108571,12783,809087,7430,2926,832226,10356,20709,-25725,44959,1475,13,1000,-137,-149,727,-286
8/10/2021,3718821,437055,3171147,110619,12824,810308,7495,3024,833651,10519,32081,-11453,41486,2048,41,1221,65,98,1425,163
8/11/2021,3749446,426170,3211078,112198,12866,811642,7873,3228,835609,11101,30625,-10885,39931,1579,42,1334,378,204,1958,582
8/12/2021,3774155,412776,3247715,113664,12908,813898,7008,2873,836687,9881,24709,-13394,36637,1466,42,2256,-865,-355,1078,-1220
8/13/2021,3804943,400129,3289718,115096,12976,815468,6724,2729,837897,9453,30788,-12647,42003,1432,68,1570,-284,-144,1210,-428
8/14/2021,3833541,395577,3321598,116366,13005,816687,6748,2820,839260,9568,28598,-4552,31880,1270,29,1219,24,91,1363,115
8/15/2021,3854354,384807,3351959,117588,13022,817764,6755,2901,840442,9656,20813,-10770,30361,1222,17,1077,7,81,1182,88
8/16/2021,3871738,371021,3381884,118833,13050,818700,6290,2915,840955,9205,17384,-13786,29925,1245,28,936,-465,14,513,-451
8/17/2021,3892479,358357,3414109,120013,13074,819620,5955,2961,841610,8916,20741,-12664,32225,1180,24,920,-335,46,655,-289
8/18/2021,3908247,343203,3443903,121141,13087,820517,6006,3029,842639,9035,15768,-15154,29794,1128,13,897,51,68,1029,119
8/19/2021,3930300,334752,3472915,122633,13121,821451,5794,3004,843370,8798,22053,-8451,29012,1492,34,934,-212,-25,731,-237
8/20/2021,3950304,327286,3499037,123981,13132,822399,5721,3087,844339,8808,20004,-7466,26122,1348,11,948,-73,83,969,10
8/21/2021,3967048,319658,3522048,125342,13152,823314,5565,3199,845230,8764,16744,-7628,23011,1361,20,915,-156,112,891,-44
8/22/2021,3979456,306760,3546324,126372,13173,824227,5584,2947,845931,8531,12408,-12898,24276,1030,21,913,19,-252,701,-233
8/23/2021,3989060,290764,3571082,127214,13193,824958,5477,2788,846416,8265,9604,-15996,24758,842,20,731,-107,-159,485,-266
8/24/2021,4008166,273750,3606164,128252,13203,825573,5277,2847,846900,8124,19106,-17014,35082,1038,10,615,-200,59,484,-141
8/25/2021,4026837,257677,3639867,129293,13214,826302,5442,2731,847689,8173,18671,-16073,33703,1041,11,729,165,-116,789,49
8/26/2021,4043736,243588,3669966,130182,13216,827333,5110,2604,848263,7714,16899,-14089,30099,889,2,1031,-332,-127,574,-459
8/27/2021,4056354,236317,3689256,130781,13232,827674,5491,2504,848901,7995,12618,-7271,19290,599,16,341,381,-100,638,281
8/28/2021,4066404,227182,3707850,131372,13242,828125,5607,2395,849369,8002,10050,-9135,18594,591,10,451,116,-109,468,7
8/29/2021,4073831,217590,3724318,131923,13252,828838,5497,2256,849843,7753,7427,-9592,16468,551,10,713,-110,-139,474,-249
8/30/2021,4079267,203060,3743716,132491,13261,829668,5097,2158,850184,7255,5436,-14530,19398,568,9,830,-400,-98,341,-498
8/31/2021,4089801,196281,3760497,133023,13290,830197,4980,2116,850583,7096,10534,-6779,16781,532,29,529,-117,-42,399,-159
9/1/2021,4100138,189571,3776891,133676,13302,831293,4489,2172,851256,6661,10337,-6710,16394,653,12,1096,-491,56,673,-435
9/2/2021,4109093,176638,3798099,134356,13312,832130,4201,2043,851686,6244,8955,-12933,21208,680,10,837,-288,-129,430,-417
9/3/2021,4116890,168317,3813643,134930,13322,832952,3841,1914,852029,5755,7797,-8321,15544,574,10,822,-360,-129,343,-489
9/4/2021,4123617,160699,3827449,135469,13332,833437,3807,1813,852389,5620,6727,-7618,13806,539,10,485,-34,-101,360,-135
9/5/2021,4129020,155519,3837640,135861,13342,833765,3820,1765,852692,5585,5403,-5180,10191,392,10,328,13,-48,303,-35
9/6/2021,4133433,146271,3850689,136473,13359,834489,3417,1644,852909,5061,4413,-9248,13049,612,17,724,-403,-121,217,-524
9/7/2021,4140634,138630,3864848,137156,13372,835030,3172,1597,853171,4769,7201,-7641,14159,683,13,541,-245,-47,262,-292
9/8/2021,4147365,132823,3876760,137782,13386,835700,2977,1536,853599,4513,6731,-5807,11912,626,14,670,-195,-61,428,-256
9/9/2021,4153355,127829,3887410,138116,13399,836187,2843,1478,853907,4321,5990,-4994,10650,334,13,487,-134,-58,308,-192
9/10/2021,4158731,118534,3901766,138431,13411,836644,2659,1454,854168,4113,5376,-9295,14356,315,12,457,-184,-24,261,-208
9/11/2021,4163732,115679,3909352,138701,13431,837033,2554,1418,854436,3972,5001,-2855,7586,270,20,389,-105,-36,268,-141
9/12/2021,4167511,109869,3918753,138889,13437,837364,2539,1402,854742,3941,3779,-5810,9401,188,6,331,-15,-16,306,-31
9/13/2021,4170088,99696,3931227,139165,13443,837805,2454,1227,854929,3681,2577,-10173,12474,276,6,441,-85,-175,187,-260
9/14/2021,4174216,92328,3942473,139415,13445,838306,2268,1100,855119,3368,4128,-7368,11246,250,2,501,-186,-127,190,-313
9/15/2021,4178164,84963,3953519,139682,13455,838680,2223,1066,855424,3289,3948,-7365,11046,267,10,374,-45,-34,305,-79
9/16/2021,4181309,73238,3968152,139919,13464,839022,2092,1022,855600,3114,3145,-11725,14633,237,9,342,-131,-44,176,-175
9/17/2021,4185144,68942,3976064,140138,13469,839379,1958,1000,855806,2958,3835,-4296,7912,219,5,357,-134,-22,206,-156
9/18/2021,4188529,65066,3983140,140323,13475,839623,1934,974,856006,2908,3385,-3876,7076,185,6,244,-24,-26,200,-50
9/19/2021,4190763,60969,3989326,140468,13479,839803,1916,963,856161,2879,2234,-4097,6186,145,4,180,-18,-11,155,-29
9/20/2021,4192695,55936,3996125,140634,13482,840212,1694,864,856252,2558,1932,-5033,6799,166,3,409,-222,-99,91,-321
9/21/2021,4195958,52447,4002706,140805,13486,840525,1552,795,856358,2347,3263,-3489,6581,171,4,313,-142,-69,106,-211
9/22/2021,4198678,49662,4008062,140954,13490,840812,1509,774,856585,2283,2720,-2785,5356,149,4,287,-43,-21,227,-64
9/23/2021,4201559,47997,4012448,141114,13493,841065,1505,687,856750,2192,2881,-1665,4386,160,3,253,-4,-87,165,-91
9/24/2021,4204116,45803,4017055,141258,13497,841393,1409,632,856931,2041,2557,-2194,4607,144,4,328,-96,-55,181,-151
9/25/2021,4206253,44071,4020801,141381,13500,841592,1381,591,857064,1972,2137,-1732,3746,123,3,199,-28,-41,133,-69
9/26/2021,4208013,42769,4023777,141467,13503,841719,1403,607,857232,2010,1760,-1302,2976,86,3,127,22,16,168,38
9/27/2021,4209403,40270,4027548,141585,13507,841980,1296,552,857335,1848,1390,-2499,3771,118,4,261,-107,-55,103,-162
9/28/2021,4211460,38652,4031099,141709,13512,842141,1246,540,857439,1786,2057,-1618,3551,124,5,161,-50,-12,104,-62
9/29/2021,4213414,37412,4034176,141826,13516,842336,1230,534,857616,1764,1954,-1240,3077,117,4,195,-16,-6,177,-22
9/30/2021,4215104,36141,4037024,141939,13519,842541,1195,510,857765,1705,1690,-1271,2848,113,3,205,-35,-24,149,-59
10/1/2021,4216728,34867,4039835,142026,13524,842715,1173,504,857916,1677,1624,-1274,2811,87,5,174,-22,-6,151,-28
10/2/2021,4218142,33812,4042215,142115,13529,842842,1217,483,858071,1700,1414,-1055,2380,89,5,127,44,-21,155,23
10/3/2021,4219284,32876,4044235,142173,13534,842929,1235,500,858198,1735,1142,-936,2020,58,5,87,18,17,127,35
10/4/2021,4220206,31054,4046891,142261,13534,843091,1261,461,858347,1722,922,-1822,2656,88,0,162,26,-39,149,-13
10/5/2021,4221610,29823,4049449,142338,13538,843239,1198,444,858419,1642,1404,-1231,2558,77,4,148,-63,-17,72,-80
10/6/2021,4223094,28381,4052300,142413,13540,843414,1217,451,858622,1668,1484,-1442,2851,75,2,175,19,7,203,26
10/7/2021,4224487,27747,4054246,142494,13541,843529,1253,448,858771,1701,1393,-634,1946,81,1,115,36,-3,149,33
10/8/2021,4225871,25551,4057760,142560,13541,843738,1206,436,858921,1642,1384,-2196,3514,66,0,209,-47,-12,150,-59
10/9/2021,4227038,25159,4059267,142612,13543,843822,1229,427,859021,1656,1167,-392,1507,52,2,84,23,-9,100,14
10/10/2021,4227932,24430,4060851,142651,13547,843891,1285,438,859161,1723,894,-729,1584,39,4,69,56,11,140,67
10/11/2021,4228552,22541,4063295,142716,13549,844189,1078,386,859202,1464,620,-1889,2444,65,2,298,-207,-52,41,-259
10/12/2021,4229813,21625,4065425,142763,13550,844538,947,310,859345,1257,1261,-916,2130,47,1,349,-131,-76,143,-207
10/13/2021,4231046,20551,4067684,142811,13550,844742,972,359,859623,1331,1233,-1074,2259,48,0,204,25,49,278,74
10/14/2021,4232099,19852,4069399,142848,13550,844839,978,369,859736,1347,1053,-699,1715,37,0,97,6,10,113,16
10/15/2021,4233014,19318,4070807,142889,13550,844901,1030,379,859860,1409,915,-534,1408,41,0,62,52,10,124,62
10/16/2021,4234011,18746,4072332,142933,13551,845121,992,350,860014,1342,997,-572,1525,44,1,220,-38,-29,154,-67
10/17/2021,4234758,18388,4073418,142952,13551,845248,998,348,860145,1346,747,-358,1086,19,0,127,6,-2,131,4
10/18/2021,4235384,17374,4075011,142999,13552,845386,984,330,860252,1314,626,-1014,1593,47,1,138,-14,-18,107,-32
10/19/2021,4236287,16697,4076541,143049,13552,845508,967,331,860358,1298,903,-677,1530,50,0,122,-17,1,106,-16
10/20/2021,4237201,16376,4077748,143077,13552,845650,947,312,860461,1259,914,-321,1207,28,0,142,-20,-19,103,-39
10/21/2021,4237834,15594,4079120,143120,13553,845763,934,300,860550,1234,633,-782,1372,43,1,113,-13,-12,89,-25
10/22/2021,4238594,15090,4080351,143153,13553,845884,895,301,860633,1196,760,-504,1231,33,0,121,-39,1,83,-38
10/23/2021,4239396,14803,4081417,143176,13555,846056,846,292,860749,1138,802,-287,1066,23,2,172,-49,-9,116,-58
10/24/2021,4240019,14360,4082454,143205,13556,846185,852,287,860880,1139,623,-443,1037,29,1,129,6,-5,131,1
10/25/2021,4240479,13554,4083690,143235,13557,846352,774,279,860962,1053,460,-806,1236,30,1,167,-78,-8,82,-86
10/26/2021,4241090,12989,4084831,143270,13558,846525,660,256,860999,916,611,-565,1141,35,1,173,-114,-23,37,-137
10/27/2021,4241809,12735,4085775,143299,13559,846667,618,260,861104,878,719,-254,944,29,1,142,-42,4,105,-38
10/28/2021,4242532,12440,4086759,143333,13560,846749,670,256,861235,926,723,-295,984,34,1,82,52,-4,131,48
10/29/2021,4243215,12414,4087440,143361,13560,846799,713,259,861331,972,683,-26,681,28,0,50,43,3,96,46
10/30/2021,4243835,12309,4088138,143388,13561,846942,660,264,861427,924,620,-105,698,27,1,143,-53,5,96,-48
10/31/2021,4244358,12318,4088635,143405,13562,847021,686,271,861540,957,523,9,497,17,1,79,26,7,113,33
11/1/2021,4244761,11919,4089419,143423,13562,847066,722,273,861623,995,403,-399,784,18,0,45,36,2,83,38
11/2/2021,4245373,11629,4090287,143457,13562,847201,671,266,861700,937,612,-290,868,34,0,135,-51,-7,77,-58
11/3/2021,4246174,11592,4091101,143481,13563,847353,658,258,861832,916,801,-37,814,24,1,152,-13,-8,132,-21
11/4/2021,4246802,11364,4091938,143500,13564,847403,718,258,861943,976,628,-228,837,19,1,50,60,0,111,60
11/5/2021,4247320,11215,4092586,143519,13565,847438,802,256,862061,1058,518,-149,648,19,1,35,84,-2,118,82
11/6/2021,4247721,10979,4093208,143534,13566,847685,648,231,862130,879,401,-236,622,15,1,247,-154,-25,69,-179
11/7/2021,4248165,10825,4093795,143545,13566,847808,653,220,862247,873,444,-154,587,11,0,123,5,-11,117,-6
11/8/2021,4248409,9774,4095078,143557,13566,847885,627,198,862276,825,244,-1051,1283,12,0,77,-26,-22,29,-48
11/9/2021,4248843,9602,4095663,143578,13566,848034,577,193,862370,770,434,-172,585,21,0,149,-50,-5,94,-55
11/10/2021,4249323,9537,4096194,143592,13566,848093,608,198,862465,806,480,-65,531,14,0,59,31,5,95,36
11/11/2021,4249758,9486,4096664,143608,13567,848137,660,208,862572,868,435,-51,470,16,1,44,52,10,107,62
11/12/2021,4250157,9305,4097224,143628,13567,848311,578,187,862643,765,399,-181,560,20,0,174,-82,-21,71,-103
11/13/2021,4250516,9197,4097675,143644,13567,848419,534,177,862697,711,359,-108,451,16,0,108,-44,-10,54,-54
11/14/2021,4250855,9018,4098178,143659,13568,848527,514,180,862789,694,339,-179,503,15,1,108,-20,3,92,-17
11/15/2021,4251076,8522,4098884,143670,13569,848604,477,175,862825,652,221,-496,706,11,1,77,-37,-5,36,-42
11/16/2021,4251423,8339,4099399,143685,13569,848710,447,178,862904,625,347,-183,515,15,0,106,-30,3,79,-27
11/17/2021,4251945,8390,4099857,143698,13570,848871,397,196,863034,593,522,51,458,13,1,161,-50,18,130,-32
11/18/2021,4252345,8315,4100321,143709,13571,849007,344,212,863134,556,400,-75,464,11,1,136,-53,16,100,-37
11/19/2021,4252705,8154,4100837,143714,13573,849111,348,199,863231,547,360,-161,516,5,2,104,4,-13,97,-9
11/20/2021,4253098,8154,4101216,143728,13574,849265,297,209,863345,506,393,0,379,14,1,154,-51,10,114,-41
11/21/2021,4253412,8126,4101547,143739,13574,849386,296,200,863456,496,314,-28,331,11,0,121,-1,-9,111,-10
11/22/2021,4253598,7965,4101889,143744,13574,849448,278,182,863482,460,186,-161,342,5,0,62,-18,-18,26,-36
11/23/2021,4253992,7916,4102323,143753,13574,849491,303,183,863551,486,394,-49,434,9,0,43,25,1,69,26
11/24/2021,4254443,7977,4102700,143766,13575,849596,294,168,863633,462,451,61,377,13,1,105,-9,-15,82,-24
11/25/2021,4254815,8040,4102993,143782,13576,849638,274,199,863687,473,372,63,293,16,1,42,-20,31,54,11
11/26/2021,4255268,8093,4103379,143796,13576,849693,292,196,863757,488,453,53,386,14,0,55,18,-3,70,15
11/27/2021,4255672,8226,4103639,143807,13576,849779,252,204,863811,456,404,133,260,11,0,86,-40,8,54,-32
11/28/2021,4255936,8214,4103914,143808,13576,849831,272,183,863862,455,264,-12,275,1,0,52,20,-21,51,-1
11/29/2021,4256112,7960,4104333,143819,13576,849902,255,170,863903,425,176,-254,419,11,0,71,-17,-13,41,-30
11/30/2021,4256409,7922,4104657,143830,13576,849929,264,178,863947,442,297,-38,324,11,0,27,9,8,44,17
12/1/2021,4256687,7883,4104964,143840,13576,849979,282,180,864017,462,278,-39,307,10,0,50,18,2,70,20
12/2/2021,4256998,7796,4105352,143850,13576,850046,248,175,864045,423,311,-87,388,10,0,67,-34,-5,28,-39
12/3/2021,4257243,7705,4105680,143858,13577,850114,229,167,864087,396,245,-91,328,8,1,68,-19,-8,42,-27
12/4/2021,4257489,7632,4105994,143863,13578,850175,209,173,864135,382,246,-73,314,5,1,61,-20,6,48,-14
12/5/2021,4257685,7526,4106292,143867,13579,850228,210,161,864178,371,196,-106,298,4,1,53,1,-12,43,-11
12/6/2021,4257815,5642,4108297,143876,13581,850281,181,149,864192,330,130,-1884,2005,9,2,53,-29,-12,14,-41
12/7/2021,4258076,5466,4108717,143893,13582,850319,171,151,864223,322,261,-176,420,17,1,38,-10,2,31,-8
12/8/2021,4258340,5363,4109068,143909,13583,850364,170,147,864264,317,264,-103,351,16,1,45,-1,-4,41,-5
12/9/2021,4258560,5278,4109364,143918,13583,850439,153,125,864300,278,220,-85,296,9,0,75,-17,-22,36,-39
12/10/2021,4258752,5154,4109675,143923,13583,850475,144,124,864326,268,192,-124,311,5,0,36,-9,-1,26,-10
12/11/2021,4258980,5186,4109865,143929,13583,850517,132,126,864358,258,228,32,190,6,0,42,-12,2,32,-10
12/12/2021,4259143,5158,4110049,143936,13583,850557,128,122,864390,250,163,-28,184,7,0,40,-4,-4,32,-8
12/13/2021,4259249,4974,4110327,143948,13583,850595,111,117,864406,228,106,-184,278,12,0,38,-17,-5,16,-22
12/14/2021,4259439,4905,4110574,143960,13583,850621,103,119,864426,222,190,-69,247,12,0,26,-8,2,20,-6
12/15/2021,4259644,4864,4110811,143969,13583,850649,104,113,864449,217,205,-41,237,9,0,28,1,-6,23,-5
12/16/2021,4259857,4833,4111045,143979,13583,850685,108,113,864489,221,213,-31,234,10,0,36,4,0,40,4
12/17/2021,4260148,4912,4111250,143986,13583,850719,118,107,864527,225,291,79,205,7,0,34,10,-6,38,4
12/18/2021,4260380,4918,4111464,143998,13583,850751,136,131,864601,267,232,6,214,12,0,32,18,24,74,42
12/19/2021,4260544,4923,4111619,144002,13583,850797,140,124,864644,264,164,5,155,4,0,46,4,-7,43,-3
12/20/2021,4260677,4829,4111835,144013,13584,850817,150,131,864682,281,133,-94,216,11,1,20,10,7,38,17
12/21/2021,4260893,4829,4112040,144024,13584,850837,160,156,864737,316,216,0,205,11,0,20,10,25,55,35
12/22/2021,4261072,4746,4112292,144034,13584,850858,176,162,864780,338,179,-83,252,10,0,21,16,6,43,22
12/23/2021,4261208,4642,4112524,144042,13584,850910,157,145,864796,302,136,-104,232,8,0,52,-19,-17,16,-36
12/24/2021,4261412,4659,4112706,144047,13584,850939,168,174,864865,342,204,17,182,5,0,29,11,29,69,40
12/25/2021,4261667,4713,4112901,144053,13584,850984,170,207,864945,377,255,54,195,6,0,45,2,33,80,35
12/26/2021,4261759,4655,4113049,144055,13584,851008,176,224,864992,400,92,-58,148,2,0,24,6,17,47,23
12/27/2021,4261879,4496,4113320,144063,13584,851096,171,183,865034,354,120,-159,271,8,0,88,-5,-41,42,-46
12/28/2021,4262157,4614,4113472,144071,13585,851138,236,171,865130,407,278,118,152,8,1,42,65,-12,96,53
12/29/2021,4262351,4528,4113742,144081,13587,851167,238,165,865157,403,194,-86,270,10,2,29,2,-6,27,-4
12/30/2021,4262540,4311,4114141,144088,13587,851201,251,171,865210,422,189,-217,399,7,0,34,13,6,53,19
12/31/2021,4262720,4292,4114334,144094,13588,851222,295,192,865297,487,180,-19,193,6,1,21,44,21,87,65
1/1/2022,4262994,4399,4114499,144096,13588,851280,342,205,865415,547,274,107,165,2,0,58,47,13,118,60
1/2/2022,4263168,4382,4114689,144097,13588,851386,428,116,865518,544,174,-17,190,1,0,106,86,-89,103,-3
1/3/2022,4263433,4530,4114801,144102,13588,851408,554,140,865690,694,265,148,112,5,0,22,126,24,172,150
1/4/2022,4263732,4658,4114969,144105,13588,851449,627,141,865805,768,299,128,168,3,0,41,73,1,115,74
1/5/2022,4264136,4878,4115149,144109,13589,851520,787,168,866064,955,404,220,180,4,1,71,160,27,259,187
1/6/2022,4264669,5195,4115358,144116,13589,851572,956,214,866331,1170,533,317,209,7,0,52,169,46,267,215
1/7/2022,4265187,5494,4115572,144121,13589,851648,1173,221,866631,1394,518,299,214,5,0,76,217,7,300,224
1/8/2022,4265666,5792,4115747,144127,13589,851727,1336,257,866909,1593,479,298,175,6,0,79,163,36,278,199
1/9/2022,4266195,6108,4115958,144129,13589,851839,1575,299,867302,1874,529,316,211,2,0,112,239,42,393,281
1/10/2022,4266649,6311,4116202,144136,13589,851944,1807,322,867662,2129,454,203,244,7,0,105,232,23,360,255
1/11/2022,4267451,6659,4116648,144144,13590,852126,2081,402,868199,2483,802,348,446,8,1,182,274,80,537,354
1/12/2022,4268097,6985,4116962,144150,13590,852269,2246,506,868611,2752,646,326,314,6,0,143,165,104,412,269
1/13/2022,4268890,7388,4117347,144155,13590,852563,2353,583,869089,2936,793,403,385,5,0,294,107,77,478,184
1/14/2022,4269740,7877,4117700,144163,13591,852727,2656,669,869643,3325,850,489,353,8,1,164,303,86,554,389
1/15/2022,4270794,8463,4118164,144167,13591,853003,3011,758,870363,3769,1054,586,464,4,0,276,355,89,720,444
1/16/2022,4271649,8605,4118874,144170,13591,853522,3045,771,870929,3816,855,142,710,3,0,519,34,13,566,47
1/17/2022,4272421,8775,4119472,144174,13591,853987,3035,809,871422,3844,772,170,598,4,0,465,-10,38,493,28
1/18/2022,4273783,9564,4120036,144183,13591,854204,3316,981,872092,4297,1362,789,564,9,0,217,281,172,670,453
1/19/2022,4275528,10796,4120540,144192,13591,854589,3799,1125,873104,4924,1745,1232,504,9,0,385,483,144,1012,627
1/20/2022,4277644,12328,4121117,144199,13591,855026,4420,1222,874259,5642,2116,1532,577,7,0,437,621,97,1155,718
1/21/2022,4280248,14119,4121928,144201,13591,855676,5031,1445,875743,6476,2604,1791,811,2,0,650,611,223,1484,834
1/22/2022,4283453,16692,4122555,144206,13591,856137,6130,1710,877568,7840,3205,2573,627,5,0,461,1099,265,1825,1364
1/23/2022,4286378,18891,4123267,144220,13597,856653,7046,2011,879307,9057,2925,2199,712,14,6,516,916,301,1739,1217
1/24/2022,4289305,20867,4124211,144227,13597,857215,8246,2242,881300,10488,2927,1976,944,7,0,562,1200,231,1993,1431
1/25/2022,4294183,24856,4125080,144247,13606,857688,9475,2721,883490,12196,4878,3989,869,20,9,473,1229,479,2190,1708
1/26/2022,4301193,29277,4127662,144254,13612,859305,10850,3232,886999,14082,7010,4421,2582,7,6,1617,1375,511,3509,1886
1/27/2022,4309270,35704,4129305,144261,13615,861203,12341,3989,891148,16330,8077,6427,1643,7,3,1898,1491,757,4149,2248
1/28/2022,4319175,43574,4131333,144268,13617,862670,14710,4709,895706,19419,9905,7870,2028,7,2,1467,2369,720,4558,3089
1/29/2022,4330763,52555,4133923,144285,13627,864447,17852,5545,901471,23397,11588,8981,2590,17,10,1777,3142,836,5765,3978
1/30/2022,4343185,61718,4137164,144303,13639,866477,21629,6348,908093,27977,12422,9163,3241,18,12,2030,3777,803,6622,4580
1/31/2022,4353370,68596,4140454,144320,13666,867519,25361,6809,913355,32170,10185,6878,3290,17,27,1042,3732,461,5262,4193
2/1/2022,4369391,81349,4143694,144348,13678,869184,28863,8018,919743,36881,16021,12753,3240,28,12,1665,3502,1209,6388,4711
2/2/2022,4387286,94109,4148804,144373,13689,873212,33384,8590,928875,41974,17895,12760,5110,25,11,4028,4521,572,9132,5093
2/3/2022,4414483,115275,4154797,144411,13713,877579,38248,9652,939192,47900,27197,21166,5993,38,24,4367,4864,1062,10317,5926
2/4/2022,4446694,140254,4161987,144453,13738,883377,43722,11534,952371,55256,32211,24979,7190,42,25,5798,5474,1882,13179,7356
2/5/2022,4480423,163468,4172458,144497,13767,891571,46609,13198,965145,59807,33729,23214,10471,44,29,8194,2887,1664,12774,4551
2/6/2022,4516480,188899,4183027,144554,13794,899957,52594,14625,980970,67219,36057,25431,10569,57,27,8386,5985,1427,15825,7412
2/7/2022,4542601,206361,4191604,144636,13832,905285,59023,15512,993652,74535,26121,17462,8577,82,38,5328,6429,887,12682,7316
2/8/2022,4580093,233062,4202312,144719,13872,910435,62941,17221,1004469,80162,37492,26701,10708,83,40,5150,3918,1709,10817,5627
2/9/2022,4626936,265824,4216328,144784,13889,923652,63131,18150,1018822,81281,46843,32762,14016,65,17,13217,190,929,14353,1119
2/10/2022,4667554,288186,4234510,144858,13911,929100,67456,19445,1029912,86901,40618,22362,18182,74,22,5448,4325,1295,11090,5620
2/11/2022,4708043,312808,4250277,144958,13950,945079,61665,19925,1040619,81590,40489,24622,15767,100,39,15979,-5791,480,10707,-5311
2/12/2022,4763252,335340,4282847,145065,13989,960624,59225,19198,1053036,78423,55209,22532,32570,107,39,15545,-2440,-727,12417,-3167
2/13/2022,4807778,352839,4309763,145176,14032,975674,54602,18900,1063208,73502,44526,17499,26916,111,43,15050,-4623,-298,10172,-4921
2/14/2022,4844279,375857,4323101,145321,14085,975770,62755,20873,1073483,83628,36501,23018,13338,145,53,96,8153,1973,10275,10126
2/15/2022,4901328,406025,4349848,145455,14135,984861,63221,20748,1082965,83969,57049,30168,26747,134,50,9091,466,-125,9482,341
2/16/2022,4966046,445190,4375234,145622,14191,992213,67232,21717,1095353,88949,64718,39165,25386,167,56,7352,4011,969,12388,4980
2/17/2022,5030002,469868,4414306,145828,14255,1008870,60632,20132,1103889,80764,63956,24678,39072,206,64,16657,-6600,-1585,8536,-8185
2/18/2022,5089637,496383,4447210,146044,14301,1020564,68649,8564,1112078,77213,59635,26515,32904,216,46,11694,8017,-11568,8189,-3551
2/19/2022,5149021,520910,4481909,146202,14326,1031739,67464,8002,1121531,75466,59384,24527,34699,158,25,11175,-1185,-562,9453,-1747
2/20/2022,5197505,536358,4514782,146365,14358,1043718,63658,7933,1129667,71591,48484,15448,32873,163,32,11979,-3806,-69,8136,-3875
2/21/2022,5231923,530671,4554711,146541,14382,1055584,57957,7102,1135025,65059,34418,-5687,39929,176,24,11866,-5701,-831,5358,-6532
2/22/2022,5289414,549431,4593185,146798,14415,1064272,54492,7054,1140233,61546,57491,18760,38474,257,33,8688,-3465,-48,5208,-3513
2/23/2022,5350902,571522,4632355,147025,14466,1071054,55116,6892,1147528,62008,61488,22091,39170,227,51,6782,624,-162,7295,462
2/24/2022,5408328,586113,4674873,147342,14513,1082827,50250,6793,1154383,57043,57426,14591,42518,317,47,11773,-4866,-99,6855,-4965
2/25/2022,5457775,573955,4736234,147586,14555,1091226,46586,6540,1158907,53126,49447,-12158,61361,244,42,8399,-3664,-253,4524,-3917
2/26/2022,5504418,578535,4778039,147844,14585,1100117,42956,5924,1163582,48880,46643,4580,41805,258,30,8891,-3630,-616,4675,-4246
2/27/2022,5539394,573898,4817423,148073,14609,1109056,38294,5580,1167539,43874,34976,-4637,39384,229,24,8939,-4662,-344,3957,-5006
2/28/2022,5564448,554698,4861415,148335,14664,1120433,34301,5441,1174839,39742,25054,-19200,43992,262,55,11377,-3993,-139,7300,-4132
3/1/2022,5589176,539210,4901302,148664,14690,1126008,32698,5077,1178473,37775,24728,-15488,39887,329,26,5575,-1603,-364,3634,-1967
3/2/2022,5630096,536823,4944237,149036,14710,1129828,33246,4885,1182669,38131,40920,-2387,42935,372,20,3820,548,-192,4196,356
3/3/2022,5667355,531696,4986391,149268,14730,1137499,30582,4527,1187338,35109,37259,-5127,42154,232,20,7671,-2664,-358,4669,-3022
3/4/2022,5693702,517253,5026853,149596,14754,1143134,28620,4557,1191065,33177,26347,-14443,40462,328,24,5635,-1962,30,3727,-1932
3/5/2022,5723858,500418,5073522,149918,14779,1148415,26276,4654,1194124,30930,30156,-16835,46669,322,25,5281,-2344,97,3059,-2247
3/6/2022,5748725,475951,5122602,150172,14798,1152865,25515,4615,1197793,30130,24867,-24467,49080,254,19,4450,-761,-39,3669,-800
3/7/2022,5770105,448273,5171402,150430,14828,1156926,23985,4747,1200486,28732,21380,-27678,48800,258,30,4061,-1530,132,2693,-1398
3/8/2022,5800253,422892,5226530,150831,14852,1161139,23353,4711,1204055,28064,30148,-25381,55128,401,24,4213,-632,-36,3569,-668
3/9/2022,5826589,417219,5258235,151135,14863,1164852,23627,4585,1207927,28212,26336,-5673,31705,304,11,3713,274,-126,3872,148
3/10/2022,5847900,399852,5296634,151413,14881,1168549,23480,4563,1211473,28043,21311,-17367,38399,278,18,3697,-147,-22,3546,-169
3/11/2022,5864010,376461,5335846,151703,14896,1173761,21240,4124,1214021,25364,16110,-23391,39212,290,15,5212,-2240,-439,2548,-2679
3/12/2022,5878910,357380,5369579,151951,14921,1178124,19285,3796,1216126,23081,14900,-19081,33733,248,25,4363,-1955,-328,2105,-2283
3/13/2022,5890495,342896,5395433,152166,14955,1180576,18707,3762,1218000,22469,11585,-14484,25854,215,34,2452,-578,-34,1874,-612
3/14/2022,5900124,312958,5434729,152437,14988,1184667,16373,3279,1219307,19652,9629,-29938,39296,271,33,4091,-2334,-483,1307,-2817
3/15/2022,5914532,299443,5462344,152745,15019,1187307,15603,2949,1220878,18552,14408,-13515,27615,308,31,2640,-770,-330,1571,-1100
3/16/2022,5927550,279969,5494606,152975,15031,1189556,15095,2902,1222584,17997,13018,-19474,32262,230,12,2249,-508,-47,1706,-555
3/17/2022,5939082,262477,5523393,153212,15043,1193225,13384,2515,1224167,15899,11532,-17492,28787,237,12,3669,-1711,-387,1583,-2098
3/18/2022,5948610,245979,5549220,153411,15061,1196098,12052,2472,1225683,14524,9528,-16498,25827,199,18,2873,-1332,-43,1516,-1375
3/19/2022,5956561,229734,5573228,153599,15073,1198669,11111,2315,1227168,13426,7951,-16245,24008,188,12,2571,-941,-157,1485,-1098
3/20/2022,5962483,219688,5589057,153738,15087,1200920,10004,2324,1228335,12328,5922,-10046,15829,139,14,2251,-1107,9,1167,-1098
3/21/2022,5967182,203345,5609945,153892,15093,1202740,9084,2280,1229197,11364,4699,-16343,20888,154,6,1820,-920,-44,862,-964
3/22/2022,5974646,181555,5639029,154062,15102,1204167,8773,2167,1230209,10940,7464,-21790,29084,170,9,1427,-311,-113,1012,-424
3/23/2022,5981022,168563,5658238,154221,15106,1205353,8903,2082,1231444,10985,6376,-12992,19209,159,4,1186,130,-85,1235,45
3/24/2022,5986830,155977,5676510,154343,15111,1207258,8098,2044,1232511,10142,5808,-12586,18272,122,5,1905,-805,-38,1067,-843
3/25/2022,5991687,146004,5691220,154463,15116,1208909,7445,1931,1233401,9376,4857,-9973,14710,120,5,1651,-653,-113,890,-766
3/26/2022,5995876,139143,5702163,154570,15121,1210332,6938,1806,1234197,8744,4189,-6861,10943,107,5,1423,-507,-125,796,-632
3/27/2022,5998953,129621,5714662,154670,15126,1211717,6186,1762,1234791,7948,3077,-9522,12499,100,5,1385,-752,-44,594,-796
3/28/2022,6001751,122014,5724963,154774,15138,1213009,5653,1564,1235364,7217,2798,-7607,10301,104,12,1292,-533,-198,573,-731
3/29/2022,6005646,115709,5735055,154882,15148,1213901,5744,1313,1236106,7057,3895,-6305,10092,108,10,892,91,-251,742,-160
3/30/2022,6009486,111555,5742931,155000,15159,1214728,5907,1213,1237007,7120,3840,-4154,7876,118,11,827,163,-100,901,63
3/31/2022,6012818,106927,5750802,155089,15167,1216040,5437,1092,1237736,6529,3332,-4628,7871,89,8,1312,-470,-121,729,-591
4/1/2022,6015748,100746,5759838,155164,15175,1217108,5119,975,1238377,6094,2930,-6181,9036,75,8,1068,-318,-117,641,-435
4/2/2022,6018048,98171,5764636,155241,15183,1218121,4795,911,1239010,5706,2300,-2575,4798,77,8,1013,-324,-64,633,-388
4/3/2022,6019981,95990,5768703,155288,15190,1218930,4636,866,1239622,5502,1933,-2181,4067,47,7,809,-159,-45,612,-204
4/4/2022,6021642,90235,5776058,155349,15200,1219664,4436,810,1240110,5246,1661,-5755,7355,61,10,734,-200,-56,488,-256
4/5/2022,6023924,85204,5783299,155421,15205,1220235,4420,818,1240678,5238,2282,-5031,7241,72,5,571,-16,8,568,-8
4/6/2022,6026324,82146,5788714,155464,15207,1220769,4714,741,1241431,5455,2400,-3058,5415,43,2,534,294,-77,753,217
4/7/2022,6028413,78302,5794602,155509,15212,1221596,4609,688,1242105,5297,2089,-3844,5888,45,5,827,-105,-53,674,-158
4/8/2022,6030168,76568,5798044,155556,15214,1222380,4456,647,1242697,5103,1755,-1734,3442,47,2,784,-153,-41,592,-194
4/9/2022,6031636,74130,5801909,155597,15217,1223059,4267,604,1243147,4871,1468,-2438,3865,41,3,679,-189,-43,450,-232
4/10/2022,6032707,72679,5804402,155626,15220,1223655,4039,603,1243517,4642,1071,-1451,2493,29,3,596,-228,-1,370,-229
4/11/2022,6033903,69849,5808380,155674,15224,1224308,3755,542,1243829,4297,1196,-2830,3978,48,4,653,-284,-61,312,-345
4/12/2022,6035358,67975,5811666,155717,15229,1224805,3607,543,1244184,4150,1455,-1874,3286,43,5,497,-148,1,355,-147
4/13/2022,6036909,66475,5814688,155746,15232,1225348,3515,488,1244583,4003,1551,-1500,3022,29,3,543,-92,-55,399,-147
4/14/2022,6037742,64044,5817904,155794,15234,1226139,3127,455,1244955,3582,833,-2431,3216,48,2,791,-388,-33,372,-421
4/15/2022,6038664,62665,5820179,155820,15238,1226739,2837,451,1245265,3288,922,-1379,2275,26,4,600,-290,-4,310,-294
4/16/2022,6039266,60475,5822947,155844,15240,1227338,2469,411,1245458,2880,602,-2190,2768,24,2,599,-368,-40,193,-408
4/17/2022,6039873,58278,5825729,155866,15244,1227793,2205,411,1245653,2616,607,-2197,2782,22,4,455,-264,0,195,-264
4/18/2022,6040432,50969,5833560,155903,15250,1228205,1997,371,1245823,2368,559,-7309,7831,37,6,412,-208,-40,170,-248
4/19/2022,6041269,49022,5836310,155937,15252,1228519,1876,355,1246002,2231,837,-1947,2750,34,2,314,-121,-16,179,-137
4/20/2022,6042010,45091,5840945,155974,15254,1228783,1866,330,1246233,2196,741,-3931,4635,37,2,264,-10,-25,231,-35
4/21/2022,6042595,31219,5855361,156015,15258,1229206,1603,325,1246392,1928,585,-13872,14416,41,4,423,-263,-5,159,-268
4/22/2022,6043246,21037,5866169,156040,15261,1229616,1417,313,1246607,1730,651,-10182,10808,25,3,410,-186,-12,215,-198
4/23/2022,6043768,19450,5868251,156067,15264,1229971,1256,288,1246779,1544,522,-1587,2082,27,3,355,-161,-25,172,-186
4/24/2022,6044150,17631,5870419,156100,15265,1230220,1149,280,1246914,1429,382,-1819,2168,33,1,249,-107,-8,135,-115
4/25/2022,6044467,13251,5875083,156133,15266,1230368,1107,274,1247015,1381,317,-4380,4664,33,1,148,-42,-6,101,-48
4/26/2022,6045043,9739,5879141,156163,15268,1230600,1077,269,1247214,1346,576,-3512,4058,30,2,232,-30,-5,199,-35
4/27/2022,6045660,9142,5880319,156199,15271,1230742,1053,278,1247344,1331,617,-597,1178,36,3,142,-24,9,130,-15
4/28/2022,6046072,8365,5881490,156217,15272,1230989,951,245,1247457,1196,412,-777,1171,18,1,247,-102,-33,113,-135
4/29/2022,6046467,8165,5882062,156240,15273,1231171,923,216,1247583,1139,395,-200,572,23,1,182,-28,-29,126,-57
4/30/2022,6046796,7897,5882660,156257,15274,1231413,829,218,1247734,1047,329,-268,598,17,1,242,-94,2,151,-92
5/1/2022,6047040,7474,5883293,156273,15275,1231573,756,211,1247815,967,244,-423,633,16,1,160,-73,-7,81,-80
5/2/2022,6047208,7257,5883664,156287,15277,1231709,708,209,1247903,917,168,-217,371,14,2,136,-48,-2,88,-50
5/3/2022,6047315,6951,5884059,156305,15278,1231833,623,209,1247943,832,107,-306,395,18,1,124,-85,0,40,-85
5/4/2022,6047491,6845,5884325,156321,15280,1231950,587,188,1248005,775,176,-106,266,16,2,117,-36,-21,62,-57
5/5/2022,6047741,6631,5884770,156340,15281,1232106,510,194,1248091,704,250,-214,445,19,1,156,-77,6,86,-71
5/6/2022,6047986,6530,5885099,156357,15282,1232228,476,194,1248180,670,245,-101,329,17,1,122,-34,0,89,-34
5/7/2022,6048204,6427,5885406,156371,15283,1232328,438,193,1248242,631,218,-103,307,14,1,100,-38,-1,62,-39
5/8/2022,6048431,6192,5885858,156381,15284,1232444,408,184,1248320,592,227,-235,452,10,1,116,-30,-9,78,-39
5/9/2022,6048685,6078,5886211,156396,15285,1232527,419,191,1248422,610,254,-114,353,15,1,83,11,7,102,18
5/10/2022,6049141,5855,5886870,156416,15287,1232618,490,177,1248572,667,456,-223,659,20,2,91,71,-14,150,57
5/11/2022,6049541,5331,5887786,156424,15288,1232696,549,168,1248701,717,400,-524,916,8,1,78,59,-9,129,50
5/12/2022,6049876,4867,5888571,156438,15290,1232729,614,168,1248801,782,335,-464,785,14,2,33,65,0,100,65
5/13/2022,6050211,4938,5888825,156448,15291,1232772,664,175,1248902,839,335,71,254,10,1,43,50,7,101,57
5/14/2022,6050519,4825,5889241,156453,15292,1232867,676,181,1249016,857,308,-113,416,5,1,95,12,6,114,18
5/15/2022,6050776,4784,5889534,156458,15293,1232939,686,191,1249109,877,257,-41,293,5,1,72,10,10,93,20
5/16/2022,6050958,4697,5889797,156464,15293,1233010,701,175,1249179,876,182,-87,263,6,0,71,15,-16,70,-1
5/17/2022,6051205,3898,5890826,156481,15293,1233102,670,189,1249254,859,247,-799,1029,17,0,92,-31,14,75,-17
5/18/2022,6051532,3844,5891190,156498,15294,1233206,670,197,1249367,867,327,-54,364,17,1,104,0,8,113,8
5/19/2022,6051850,3766,5891574,156510,15294,1233387,589,187,1249457,776,318,-78,384,12,0,181,-81,-10,90,-91
5/20/2022,6052100,3715,5891872,156513,15294,1233494,564,187,1249539,751,250,-51,298,3,0,107,-25,0,82,-25
5/21/2022,6052363,3718,5892126,156519,15294,1233575,581,182,1249632,763,263,3,254,6,0,81,17,-5,93,12
5/22/2022,6052590,3657,5892411,156522,15296,1233664,594,188,1249742,782,227,-61,285,3,2,89,13,6,110,19
5/23/2022,6052764,2890,5893340,156534,15297,1233779,548,176,1249800,724,174,-767,929,12,1,115,-46,-12,58,-58
5/24/2022,6053109,2933,5893628,156548,15300,1233873,580,195,1249948,775,345,43,288,14,3,94,32,19,148,51
5/25/2022,6053424,3011,5893860,156553,15300,1233937,631,208,1250076,839,315,78,232,5,0,64,51,13,128,64
5/26/2022,6053670,3011,5894103,156556,15300,1234021,669,210,1250200,879,246,0,243,3,0,84,38,2,124,40
5/27/2022,6053894,2949,5894380,156565,15300,1234087,709,214,1250310,923,224,-62,277,9,0,66,40,4,110,44
5/28/2022,6054173,2972,5894628,156573,15300,1234180,723,211,1250414,934,279,23,248,8,0,93,14,-3,104,11
5/29/2022,6054415,2952,5894889,156574,15300,1234280,722,201,1250503,923,242,-20,261,1,0,100,-1,-10,89,-11
5/30/2022,6054633,2871,5895176,156586,15303,1234376,704,201,1250584,905,218,-81,287,12,3,96,-18,0,81,-18
5/31/2022,6054973,2959,5895423,156591,15303,1234487,729,197,1250716,926,340,88,247,5,0,111,25,-4,132,21
6/1/2022,6055341,3141,5895606,156594,15303,1234566,823,188,1250880,1011,368,182,183,3,0,79,94,-9,164,85
6/2/2022,6055645,3105,5895940,156600,15303,1234723,830,182,1251038,1012,304,-36,334,6,0,157,7,-6,158,1
6/3/2022,6056017,3123,5896290,156604,15303,1234863,850,195,1251211,1045,372,18,350,4,0,140,20,13,173,33
6/4/2022,6056412,3254,5896548,156610,15303,1234976,913,192,1251384,1105,395,131,258,6,0,113,63,-3,173,60
6/5/2022,6056800,3433,5896752,156615,15303,1235069,1011,196,1251579,1207,388,179,204,5,0,93,98,4,195,102
6/6/2022,6057142,3498,5897022,156622,15303,1235172,1064,187,1251726,1251,342,65,270,7,0,103,53,-9,147,44
6/7/2022,6057660,3664,5897372,156624,15303,1235274,1222,187,1251986,1409,518,166,350,2,0,102,158,0,260,158
6/8/2022,6058180,3922,5897630,156628,15303,1235370,1417,184,1252274,1601,520,258,258,4,0,96,195,-3,288,192
6/9/2022,6058736,4061,5898040,156635,15303,1235508,1548,191,1252550,1739,556,139,410,7,0,138,131,7,276,138
6/10/2022,6059363,4341,5898384,156638,15303,1235666,1715,199,1252883,1914,627,280,344,3,0,158,167,8,333,175
6/11/2022,6059937,4538,5898758,156641,15303,1235838,1852,204,1253197,2056,574,197,374,3,0,172,137,5,314,142
6/12/2022,6060488,4680,5899165,156643,15303,1236002,2000,214,1253519,2214,551,142,407,2,0,164,148,10,322,158
6/13/2022,6061079,4926,5899501,156652,15304,1236184,2179,200,1253867,2379,591,246,336,9,1,182,179,-14,348,165
6/14/2022,6062009,5298,5900049,156662,15304,1236374,2446,260,1254384,2706,930,372,548,10,0,190,267,60,517,327
6/15/2022,6063251,6007,5900574,156670,15304,1236528,2980,302,1255114,3282,1242,709,525,8,0,154,534,42,730,576
6/16/2022,6064424,6668,5901083,156673,15305,1236820,3346,339,1255810,3685,1173,661,509,3,1,292,366,37,696,403
6/17/2022,6065644,7326,5901639,156679,15305,1237109,3712,370,1256496,4082,1220,658,556,6,0,289,366,31,686,397
6/18/2022,6066908,8062,5902162,156684,15305,1237400,4122,402,1257229,4524,1264,736,523,5,0,291,410,32,733,442
6/19/2022,6068075,8594,5902794,156687,15308,1237676,4543,437,1257964,4980,1167,532,632,3,3,276,421,35,735,456
6/20/2022,6069255,9099,5903461,156695,15309,1238059,4844,453,1258665,5297,1180,505,667,8,1,383,301,16,701,317
6/21/2022,6070933,10095,5904138,156700,15311,1238392,5420,495,1259618,5915,1678,996,677,5,2,333,576,42,953,618
6/22/2022,6072918,11391,5904825,156702,15311,1238754,6276,503,1260844,6779,1985,1296,687,2,0,362,856,8,1226,864
6/23/2022,6074825,12148,5905971,156706,15311,1239359,6714,514,1261898,7228,1907,757,1146,4,0,605,438,11,1054,449
6/24/2022,6076894,13214,5906969,156711,15313,1240028,7301,522,1263164,7823,2069,1066,998,5,2,669,587,8,1266,595
6/25/2022,6078725,13968,5908043,156714,15313,1240738,7596,562,1264209,8158,1831,754,1074,3,0,710,295,40,1045,335
6/26/2022,6080451,14516,5909218,156717,15313,1241429,7931,591,1265264,8522,1726,548,1175,3,0,691,335,29,1055,364
6/27/2022,6072918,11391,5904825,156702,15313,1242286,7901,602,1266102,8503,-7533,-3125,-4393,-15,0,857,-30,11,838,-19
6/28/2022,6084063,15310,5912025,156728,15314,1243032,8375,631,1267352,9006,11145,3919,7200,26,1,746,474,29,1250,503
6/29/2022,6086212,16174,5913307,156731,15314,1243738,8801,633,1268486,9434,2149,864,1282,3,0,706,426,2,1134,428
6/30/2022,6088460,16790,5914933,156737,15315,1244833,8926,667,1269741,9593,2248,616,1626,6,1,1095,125,34,1255,159
7/1/2022,6090509,16915,5916854,156740,15316,1245980,8829,716,1270841,9545,2049,125,1921,3,1,1147,-97,49,1100,-48
7/2/2022,6092303,16915,5918643,156745,15317,1247144,8675,688,1271824,9363,1794,0,1789,5,1,1164,-154,-28,983,-182
7/3/2022,6093917,16919,5920249,156749,15320,1248357,8333,745,1272755,9078,1614,4,1606,4,3,1213,-342,57,931,-285
7/4/2022,6095351,16476,5922117,156758,15323,1249496,7937,736,1273492,8673,1434,-443,1868,9,3,1139,-396,-9,737,-405
7/5/2022,6097928,17354,5923808,156766,15325,1250388,8267,788,1274768,9055,2577,878,1691,8,2,892,330,52,1276,382
7/6/2022,6100671,18048,5925853,156770,15327,1251237,8946,774,1276284,9720,2743,694,2045,4,2,849,679,-14,1516,665
7/7/2022,6103552,19046,5927730,156776,15329,1252398,9220,813,1277760,10033,2881,998,1877,6,2,1161,274,39,1476,313
7/8/2022,6106024,19127,5930116,156781,15331,1253562,9183,835,1278911,10018,2472,81,2386,5,2,1164,-37,22,1151,-15
7/9/2022,6108729,19855,5932089,156785,15334,1254809,9411,835,1280389,10246,2705,728,1973,4,3,1247,228,0,1478,228
7/10/2022,6111305,20535,5933979,156791,15338,1255908,10006,812,1282064,10818,2576,680,1890,6,4,1099,595,-23,1675,572
7/11/2022,6112986,20343,5935845,156798,15342,1257072,9733,729,1282876,10462,1681,-192,1866,7,4,1164,-273,-83,812,-356
7/12/2022,6116347,21916,5937625,156806,15346,1257799,10477,848,1284470,11325,3361,1573,1780,8,4,727,744,119,1594,863
7/13/2022,6120169,23787,5939564,156818,15350,1258663,11630,848,1286491,12478,3822,1871,1939,12,4,864,1153,0,2021,1153
7/14/2022,6123753,24490,5942436,156827,15356,1260234,11779,871,1288240,12650,3584,703,2872,9,6,1571,149,23,1749,172
7/15/2022,6127084,24973,5945278,156833,15359,1261863,11734,897,1289853,12631,3331,483,2842,6,3,1629,-45,26,1613,-19
7/16/2022,6131413,26594,5947980,156839,15364,1263230,12522,868,1291984,13390,4329,1621,2702,6,5,1367,788,-29,2131,759
7/17/2022,6134953,27550,5950554,156849,15367,1264902,12823,894,1293986,13717,3540,956,2574,10,3,1672,301,26,2002,327
7/18/2022,6138346,28506,5952981,156859,15369,1266257,13316,908,1295850,14224,3393,956,2427,10,2,1355,493,14,1864,507
7/19/2022,6143431,30989,5955577,156865,15371,1267430,14611,923,1298335,15534,5085,2483,2596,6,2,1173,1295,15,2485,1310
7/20/2022,6149084,34301,5957908,156875,15373,1268249,16753,910,1301285,17663,5653,3312,2331,10,2,819,2142,-13,2950,2129
7/21/2022,6154494,36781,5960833,156880,15377,1270067,17772,952,1304168,18724,5410,2480,2925,5,4,1818,1019,42,2883,1061
7/22/2022,6159328,38239,5964196,156893,15383,1271839,18440,971,1306633,19411,4834,1458,3363,13,6,1772,668,19,2465,687
7/23/2022,6164271,39065,5968304,156902,15384,1273936,19016,958,1309294,19974,4943,826,4108,9,1,2097,576,-13,2661,563
7/24/2022,6168342,40452,5970988,156902,15384,1275596,19503,962,1311445,20465,4071,1387,2684,0,0,1660,487,4,2151,491
7/25/2022,6172390,40463,5975011,156916,15386,1277873,19387,967,1313613,20354,4048,11,4023,14,2,2277,-116,5,2168,-111
7/26/2022,6178873,43422,5978522,156929,15389,1279485,20740,973,1316587,21713,6483,2959,3511,13,3,1612,1353,6,2974,1359
7/27/2022,6185311,46024,5982347,156940,15390,1281386,22097,993,1319866,23090,6438,2602,3825,11,1,1901,1357,20,3279,1377
7/28/2022,6191664,46655,5988052,156957,15392,1284419,22206,1006,1323023,23212,6353,631,5705,17,2,3033,109,13,3157,122
7/29/2022,6197495,47988,5992537,156970,15395,1286877,22675,1063,1326010,23738,5831,1333,4485,13,3,2458,469,57,2987,526
7/30/2022,6202893,49105,5996805,156983,15400,1289636,22537,1066,1328639,23603,5398,1117,4268,13,5,2759,-138,3,2629,-135
7/31/2022,6207098,48703,6001402,156993,15402,1292113,22212,1110,1330837,23322,4205,-402,4597,10,2,2477,-325,44,2198,-281
8/1/2022,6210794,47809,6005981,157004,15404,1294595,21197,1127,1332323,22324,3696,-894,4579,11,2,2482,-1015,17,1486,-998
8/2/2022,6216621,49048,6010545,157028,15408,1296794,20977,1137,1334316,22114,5827,1239,4564,24,4,2199,-220,10,1993,-210
8/3/2022,6222788,50857,6014885,157046,15412,1298981,21332,1123,1336848,22455,6167,1809,4340,18,4,2187,355,-14,2532,341
8/4/2022,6229315,50706,6021549,157060,15414,1302829,20337,1082,1339662,21419,6527,-151,6664,14,2,3848,-995,-41,2814,-1036
8/5/2022,6235244,50300,6027872,157072,15418,1305863,19869,1081,1342231,20950,5929,-406,6323,12,4,3034,-468,-1,2569,-469
8/6/2022,6240699,50895,6032722,157082,15421,1308676,19395,1095,1344587,20490,5455,595,4850,10,3,2813,-474,14,2356,-460
8/7/2022,6244978,50145,6037738,157095,15426,1311714,18209,1062,1346411,19271,4279,-750,5016,13,5,3038,-1186,-33,1824,-1219
8/8/2022,6249403,49633,6042657,157113,15429,1314435,17792,1055,1348711,18847,4425,-512,4919,18,3,2721,-417,-7,2300,-424
8/9/2022,6255679,51041,6047507,157131,15434,1316556,17947,1072,1351009,19019,6276,1408,4850,18,5,2121,155,17,2298,172
8/10/2022,6261605,52043,6052413,157149,15438,1318226,18465,1104,1353233,19569,5926,1002,4906,18,4,1670,518,32,2224,550
8/11/2022,6267137,52729,6057237,157171,15443,1320606,18298,1104,1355451,19402,5532,686,4824,22,5,2380,-167,0,2218,-167
8/12/2022,6273228,53576,6062463,157189,15445,1323161,18599,1104,1358309,19703,6091,847,5226,18,2,2555,301,0,2858,301
8/13/2022,6278332,53606,6067518,157208,15449,1325748,18259,1140,1360596,19399,5104,30,5055,19,4,2587,-340,36,2287,-304
8/14/2022,6282774,53127,6072421,157226,15452,1328058,18055,1140,1362705,19195,4442,-479,4903,18,3,2310,-204,0,2109,-204
8/15/2022,6286362,52181,6076929,157252,15455,1330248,17793,1111,1364607,18904,3588,-946,4508,26,3,2190,-262,-29,1902,-291
8/16/2022,6292231,52222,6082732,157277,15457,1332050,18439,1123,1367069,19562,5869,41,5803,25,2,1802,646,12,2462,658
8/17/2022,6297484,53132,6087056,157296,15461,1334190,18699,1123,1369473,19822,5253,910,4324,19,4,2140,260,0,2404,260
8/18/2022,6301523,51900,6092306,157317,15463,1336607,18339,1124,1371533,19463,4039,-1232,5250,21,2,2417,-360,1,2060,-359
8/19/2022,6306686,52009,6097334,157343,15468,1338895,18280,1107,1373750,19387,5163,109,5028,26,5,2288,-59,-17,2217,-76
8/20/2022,6311608,52607,6101636,157365,15471,1341152,18414,1037,1376074,19451,4922,598,4302,22,3,2257,134,-70,2324,64
8/21/2022,6315557,50500,6107680,157377,15475,1343872,17577,1047,1377971,18624,3949,-2107,6044,12,4,2720,-837,10,1897,-827
8/22/2022,6318857,48803,6112658,157396,15479,1345918,17081,1039,1379517,18120,3300,-1697,4978,19,4,2046,-496,-8,1546,-504
8/23/2022,6323715,48503,6117792,157420,15482,1347925,16706,874,1380987,17580,4858,-300,5134,24,3,2007,-375,-165,1470,-540
8/24/2022,6329143,48363,6123342,157438,15485,1349999,16846,874,1383204,17720,5428,-140,5550,18,3,2074,140,0,2217,140
8/25/2022,6334357,47778,6129122,157457,15489,1353005,16319,874,1385687,17193,5214,-585,5780,19,4,3006,-527,0,2483,-527
8/26/2022,6338906,46548,6134880,157478,15492,1355279,15849,955,1387575,16804,4549,-1230,5758,21,3,2274,-470,81,1888,-389
8/27/2022,6343076,48189,6137394,157493,15494,1356817,16221,955,1389487,17176,4170,1641,2514,15,2,1538,372,0,1912,372
8/28/2022,6346304,46366,6142438,157500,15496,1359554,14973,953,1390976,15926,3228,-1823,5044,7,2,2737,-1248,-2,1489,-1250
8/29/2022,6349175,44514,6147140,157521,15500,1361353,14392,947,1392192,15339,2871,-1852,4702,21,4,1799,-581,-6,1216,-587
8/30/2022,6354245,45054,6151650,157541,15502,1363254,14254,899,1393909,15153,5070,540,4510,20,2,1901,-138,-48,1717,-186
8/31/2022,6358808,45208,6156034,157566,15505,1364790,14632,913,1395840,15545,4563,154,4384,25,3,1536,378,14,1931,392
9/1/2022,6362902,44434,6160877,157591,15509,1366562,14599,872,1397542,15471,4094,-774,4843,25,4,1772,-33,-41,1702,-74
9/2/2022,6366518,43582,6165328,157608,15512,1368792,13876,862,1399042,14738,3616,-852,4451,17,3,2230,-723,-10,1500,-733
9/3/2022,6369778,42817,6169330,157631,15516,1371077,13059,896,1400548,13955,3260,-765,4002,23,4,2285,-817,34,1506,-783
9/4/2022,6372542,41814,6173081,157647,15519,1372751,12661,874,1401805,13535,2764,-1003,3751,16,3,1674,-398,-22,1257,-420
9/5/2022,6374882,39689,6177525,157668,15523,1374574,11841,859,1402797,12700,2340,-2125,4444,21,4,1823,-820,-15,992,-835
9/6/2022,6378489,38132,6182661,157696,15526,1375989,11816,853,1404184,12669,3607,-1557,5136,28,3,1415,-25,-6,1387,-31
9/7/2022,6382002,38119,6186166,157717,15530,1377235,12052,853,1405670,12905,3513,-13,3505,21,4,1246,236,0,1486,236
9/8/2022,6385140,37804,6189607,157729,15531,1379171,11498,788,1406988,12286,3138,-315,3441,12,1,1936,-554,-65,1318,-619
9/9/2022,6387944,35250,6194953,157741,15533,1381317,10537,767,1408154,11304,2804,-2554,5346,12,2,2146,-961,-21,1166,-982
9/10/2022,6390553,34745,6198051,157757,15534,1382928,10050,767,1409279,10817,2609,-505,3098,16,1,1611,-487,0,1125,-487
9/11/2022,6392492,33946,6200776,157770,15537,1384356,9530,711,1410134,10241,1939,-799,2725,13,3,1428,-520,-56,855,-576
9/12/2022,6394340,32312,6204241,157787,15540,1385702,8945,700,1410887,9645,1848,-1634,3465,17,3,1346,-585,-11,753,-596
9/13/2022,6397236,31571,6207858,157807,15542,1386777,8947,682,1411948,9629,2896,-741,3617,20,2,1075,2,-18,1061,-16
9/14/2022,6400035,30411,6211796,157828,15546,1387757,9226,647,1413176,9873,2799,-1160,3938,21,4,980,279,-35,1228,244
9/15/2022,6402686,29126,6215711,157849,15551,1389381,8700,660,1414292,9360,2651,-1285,3915,21,5,1624,-526,13,1116,-513
9/16/2022,6405044,28460,6218708,157876,15554,1390717,8382,660,1415313,9042,2358,-666,2997,27,3,1336,-318,0,1021,-318
9/17/2022,6407123,27850,6221389,157884,15556,1392001,8020,629,1416206,8649,2079,-610,2681,8,2,1284,-362,-31,893,-393
9/18/2022,6408806,27858,6223056,157892,15559,1392980,7832,629,1417000,8461,1683,8,1667,8,3,979,-188,0,794,-188
9/19/2022,6410426,26065,6226446,157915,15563,1394148,7317,598,1417626,7915,1620,-1793,3390,23,4,1168,-515,-31,626,-546
9/20/2022,6412944,26035,6228979,157930,15566,1394905,7544,563,1418578,8107,2518,-30,2533,15,3,757,227,-35,952,192
9/21/2022,6415328,25410,6231970,157948,15570,1395674,7774,534,1419552,8308,2384,-625,2991,18,4,769,230,-29,974,201
9/22/2022,6417490,23503,6236021,157966,15572,1396845,7455,568,1420440,8023,2162,-1907,4051,18,2,1171,-319,34,888,-285
9/23/2022,6419394,22310,6239098,157986,15574,1398121,6903,554,1421152,7457,1904,-1193,3077,20,2,1276,-552,-14,712,-566
9/24/2022,6421118,21982,6241138,157998,15575,1399122,6597,545,1421839,7142,1724,-328,2040,12,1,1001,-306,-9,687,-315
9/25/2022,6422529,20808,6243707,158014,15578,1400142,6154,545,1422419,6699,1411,-1174,2569,16,3,1020,-443,0,580,-443
9/26/2022,6423873,19288,6246549,158036,15581,1401070,5783,531,1422965,6314,1344,-1520,2842,22,3,928,-371,-14,546,-385
9/27/2022,6425849,19173,6248619,158057,15583,1401726,5857,539,1423705,6396,1976,-115,2070,21,2,656,74,8,740,82
9/28/2022,6427764,19185,6250503,158076,15586,1402392,5910,512,1424400,6422,1915,12,1884,19,3,666,53,-27,695,26
9/29/2022,6429767,18357,6253317,158093,15589,1403358,5753,481,1425181,6234,2003,-828,2814,17,3,966,-157,-31,781,-188
9/30/2022,6431624,17594,6255918,158112,15593,1404297,5507,518,1425915,6025,1857,-763,2601,19,4,939,-246,37,734,-209
10/1/2022,6433263,17697,6257444,158122,15595,1405108,5349,466,1426518,5815,1639,103,1526,10,2,811,-158,-52,603,-210
10/2/2022,6434585,17434,6259019,158132,15596,1405927,5097,449,1427069,5546,1322,-263,1575,10,1,819,-252,-17,551,-269
10/3/2022,6435719,16294,6261282,158143,15599,1406649,4755,450,1427453,5205,1134,-1140,2263,11,3,722,-342,1,384,-341
10/4/2022,6437570,16594,6262820,158156,15601,1407130,4933,457,1428121,5390,1851,300,1538,13,2,481,178,7,668,185
10/5/2022,6439292,16943,6264184,158165,15601,1407613,5089,418,1428721,5507,1722,349,1364,9,0,483,156,-39,600,117
10/6/2022,6441123,17047,6256899,158177,15601,1408456,4917,427,1429401,5344,1831,104,-7285,12,0,843,-172,9,680,-163
10/7/2022,6442624,16711,6267721,158192,15601,1409218,4674,428,1429921,5102,1501,-336,10822,15,0,762,-243,1,520,-242
10/8/2022,6443949,16489,6269262,158198,15601,1410005,4395,420,1430421,4815,1325,-222,1541,6,0,787,-279,-8,500,-287
10/9/2022,6444948,16208,6270535,158205,15602,1410653,4207,424,1430886,4631,999,-281,1273,7,1,648,-188,4,465,-184
10/10/2022,6446143,15871,6272053,158219,15602,1411237,4129,414,1431382,4543,1195,-337,1518,14,0,584,-78,-10,496,-88
10/11/2022,6448220,16392,6273593,158235,15603,1411650,4467,400,1432120,4867,2077,521,1540,16,1,413,338,-14,738,324
10/12/2022,6450248,17123,6274876,158249,15603,1412072,4793,404,1432872,5197,2028,731,1283,14,0,422,326,4,752,330
10/13/2022,6452078,17226,6276589,158263,15605,1412824,4745,406,1433580,5151,1830,103,1713,14,2,752,-48,2,708,-46
10/14/2022,6453864,17470,6278113,158281,15606,1413399,4781,406,1434192,5187,1786,244,1524,18,1,575,36,0,612,36
10/15/2022,6455542,17915,6279326,158301,15608,1413956,4799,406,1434769,5205,1678,445,1213,20,2,557,18,0,577,18
10/16/2022,6456868,17213,6281342,158313,15610,1414545,4724,408,1435287,5132,1326,-702,2016,12,2,589,-75,2,518,-73
10/17/2022,6458101,16823,6282951,158327,15611,1415045,4671,408,1435735,5079,1233,-390,1609,14,1,500,-53,0,448,-53
10/18/2022,6460265,17538,6284382,158345,15612,1415449,4965,406,1436432,5371,2164,715,1431,18,1,404,294,-2,697,292
10/19/2022,6462655,18504,6285790,158361,15614,1415986,5308,415,1437323,5723,2390,966,1408,16,2,537,343,9,891,352
10/20/2022,6464962,18919,6287663,158380,15615,1416863,5198,431,1438107,5629,2307,415,1873,19,1,877,-110,16,784,-94
10/21/2022,6467189,19158,6289633,158398,15615,1417614,5224,427,1438880,5651,2227,239,1970,18,0,751,26,-4,773,22
10/22/2022,6469276,18919,6291941,158416,15617,1418276,5198,453,1439544,5651,2087,-239,2308,18,2,662,-26,26,664,0
10/23/2022,6470961,19385,6293147,158429,15619,1418791,5324,453,1440187,5777,1685,466,1206,13,2,515,126,0,643,126
10/24/2022,6472664,18685,6295525,158454,15620,1419376,5349,467,1440812,5816,1703,-700,2378,25,1,585,25,14,625,39
10/25/2022,6475672,19915,6297282,158475,15623,1419880,5726,472,1441701,6198,3008,1230,1757,21,3,504,377,5,889,382
10/26/2022,6478720,21481,6298740,158499,15626,1420354,6288,499,1442767,6787,3048,1566,1458,24,3,474,562,27,1066,589
10/27/2022,6481749,21533,6301694,158522,15628,1421266,6400,535,1443829,6935,3029,52,2954,23,2,912,112,36,1062,148
10/28/2022,6484764,22743,6303477,158544,15628,1421980,6654,574,1444836,7228,3015,1210,1783,22,0,714,254,39,1007,293
10/29/2022,6487905,23748,6305586,158571,15631,1422831,6841,574,1445877,7415,3141,1005,2109,27,3,851,187,0,1041,187
10/30/2022,6490622,24544,6307481,158597,15633,1423547,7198,580,1446958,7778,2717,796,1895,26,2,716,357,6,1081,363
10/31/2022,6493079,24658,6309790,158631,15634,1424109,7466,571,1447780,8037,2457,114,2309,34,1,562,268,-9,822,259
11/1/2022,6497786,27262,6311861,158663,15636,1424803,8300,600,1449339,8900,4707,2604,2071,32,2,694,834,29,1559,863
11/2/2022,6502659,30053,6313911,158695,15639,1425428,9406,647,1451120,10053,4873,2791,2050,32,3,625,1106,47,1781,1153
11/3/2022,6507610,32080,6316793,158737,15642,1426549,10034,718,1452943,10752,4951,2027,2882,42,3,1121,628,71,1823,699
11/4/2022,6512913,34155,6319990,158768,15646,1427561,11054,718,1454979,11772,5303,2075,3197,31,4,1012,1020,0,2036,1020
11/5/2022,6517630,35903,6322920,158807,15649,1428603,11824,762,1456838,12586,4717,1748,2930,39,3,1042,770,44,1859,814
11/6/2022,6521292,37048,6325415,158829,15653,1429670,12254,803,1458380,13057,3662,1145,2495,22,4,1067,430,41,1542,471
11/7/2022,6525120,37486,6328763,158871,15657,1430753,12515,800,1459725,13315,3828,438,3348,42,4,1083,261,-3,1345,258
11/8/2022,6531721,40852,6331960,158909,15660,1431618,13860,841,1461979,14701,6601,3366,3197,38,3,865,1345,41,2254,1386
11/9/2022,6537907,43797,6335158,158952,15664,1432536,15495,841,1464536,16336,6186,2945,3198,43,4,918,1635,0,2557,1635
11/10/2022,6544201,45831,6339381,158989,15666,1434483,15826,957,1466932,16783,6294,2034,4223,37,2,1947,331,116,2396,447
11/11/2022,6550448,47893,6343520,159035,15671,1436280,16572,992,1469515,17564,6247,2062,4139,46,5,1797,746,35,2583,781
11/12/2022,6556627,49300,6348259,159068,15677,1438276,17004,1069,1472026,18073,6179,1407,4739,33,6,1996,432,77,2511,509
11/13/2022,6561504,49794,6352606,159104,15685,1440197,17333,1072,1474287,18405,4877,494,4347,36,8,1921,329,3,2261,332
11/14/2022,6565912,49960,6356794,159158,15693,1442034,17229,1102,1476058,18331,4408,166,4188,54,8,1837,-104,30,1771,-74
11/15/2022,6573805,53774,6360832,159199,15697,1443377,18750,1166,1478990,19916,7893,3814,4038,41,4,1343,1521,64,2932,1585
11/16/2022,6582291,57951,6365087,159253,15703,1444781,21002,1172,1482658,22174,8486,4177,4255,54,6,1404,2252,6,3668,2258
11/17/2022,6590113,60471,6370351,159291,15708,1447368,21843,1213,1486132,23056,7822,2520,5264,38,5,2587,841,41,3474,882
11/18/2022,6596812,61284,6376205,159323,15715,1450159,21849,1207,1488930,23056,6699,813,5854,32,7,2791,6,-6,2798,0
11/19/2022,6603195,62728,6381119,159348,15720,1452614,21991,1233,1491558,23224,6383,1444,4914,25,5,2455,142,26,2628,168
11/20/2022,6608367,62179,6386809,159379,15727,1455008,21965,1231,1493931,23196,5172,-549,5690,31,7,2394,-26,-2,2373,-28
11/21/2022,6612673,59587,6393664,159422,15736,1457416,21345,1223,1495720,22568,4306,-2592,6855,43,9,2408,-620,-8,1789,-628
11/22/2022,6620317,62196,6398648,159473,15750,1459200,22354,1260,1498564,23614,7644,2609,4984,51,14,1784,1009,37,2844,1046
11/23/2022,6627538,64463,6403551,159524,15757,1460904,23653,1268,1501582,24921,7221,2267,4903,51,7,1704,1299,8,3018,1307
11/24/2022,6634648,63863,6411220,159565,15766,1464960,22587,1287,1504600,23874,7110,-600,7669,41,9,4056,-1066,19,3018,-1047
11/25/2022,6640624,63052,6417972,159600,15770,1468483,21588,1309,1507150,22897,5976,-811,6752,35,4,3523,-999,22,2550,-977
11/26/2022,6646093,62120,6424332,159641,15775,1471963,20332,1315,1509385,21647,5469,-932,6360,41,5,3480,-1256,6,2235,-1250
11/27/2022,6650244,60581,6429987,159676,15782,1474496,19681,1270,1511229,20951,4151,-1539,5655,35,7,2533,-651,-45,1844,-696
11/28/2022,6653469,57883,6435851,159735,15789,1477170,18304,1262,1512525,19566,3225,-2698,5864,59,7,2674,-1377,-8,1296,-1385
11/29/2022,6659235,58119,6441327,159789,15795,1478983,18548,1219,1514545,19767,5766,236,5476,54,6,1813,244,-43,2020,201
11/30/2022,6664844,59276,6445738,159830,15801,1480792,19114,1193,1516900,20307,5609,1157,4411,41,6,1809,566,-26,2355,540
12/1/2022,6669821,57700,6452237,159884,15810,1484243,17669,1135,1518857,18804,4977,-1576,6499,54,9,3451,-1445,-58,1957,-1503
12/2/2022,6674000,55841,6458238,159921,15817,1486667,16916,1101,1520501,18017,4179,-1859,6001,37,7,2424,-753,-34,1644,-787
12/3/2022,6677655,54236,6463466,159953,15818,1489541,15491,1092,1521942,16583,3655,-1605,5228,32,1,2874,-1425,-9,1441,-1434
12/4/2022,6680203,50987,6469238,159978,15822,1492385,13741,1050,1522998,14791,2548,-3249,5772,25,4,2844,-1750,-42,1056,-1792
12/5/2022,6682437,48140,6474271,160026,15830,1494565,12359,1048,1523802,13407,2234,-2847,5033,48,8,2180,-1382,-2,804,-1384
12/6/2022,6686181,47660,6478450,160071,15834,1495989,12202,1025,1525050,13227,3744,-480,4179,45,4,1424,-157,-23,1248,-180
12/7/2022,6689532,47730,6481690,160112,15838,1497279,12233,980,1526330,13213,3351,70,3240,41,4,1290,31,-45,1280,-14
12/8/2022,6692509,45562,6486808,160139,15840,1499798,10847,883,1527368,11730,2977,-2168,5118,27,2,2519,-1386,-97,1038,-1483
12/9/2022,6695010,43316,6491519,160175,15848,1501566,9900,872,1528186,10772,2501,-2246,4711,36,8,1768,-947,-11,818,-958
12/10/2022,6697201,41977,6495026,160198,15849,1503634,8670,788,1528941,9458,2191,-1339,3507,23,1,2068,-1230,-84,755,-1314
12/11/2022,6698790,39809,6498757,160224,15854,1505189,7775,726,1529544,8501,1589,-2168,3731,26,5,1555,-895,-62,603,-957
12/12/2022,6700015,37155,6502605,160255,15856,1506506,6884,736,1529982,7620,1225,-2654,3848,31,2,1317,-891,10,438,-881
12/13/2022,6702132,35838,6506007,160287,15860,1507394,6618,696,1530568,7314,2117,-1317,3402,32,4,888,-266,-40,586,-306
12/14/2022,6704268,35442,6508515,160311,15865,1508273,6515,621,1531274,7136,2136,-396,2508,24,5,879,-103,-75,706,-178
12/15/2022,6698790,39809,6498757,160224,15867,1509640,5787,553,1531847,6340,-5478,4367,-9758,-87,2,1367,-728,-68,573,-796
12/16/2022,6707504,32042,6515100,160362,15874,1510813,5096,549,1532332,5645,8714,-7767,16343,138,7,1173,-691,-4,485,-695
12/17/2022,6708737,30884,6517469,160384,15879,1511764,4569,514,1532726,5083,1233,-1158,2369,22,5,951,-527,-35,394,-562
12/18/2022,6709597,29695,6519504,160398,15881,1512563,4085,490,1533019,4575,860,-1189,2035,14,2,799,-484,-24,293,-508
12/19/2022,6710406,27238,6522744,160424,15883,1513231,3710,479,1533303,4189,809,-2457,3240,26,2,668,-375,-11,284,-386
12/20/2022,6711703,25727,6525525,160451,15886,1513767,3513,454,1533620,3967,1297,-1511,2781,27,3,536,-197,-25,317,-222
12/21/2022,6712826,24408,6527954,160466,15890,1514226,3459,424,1533999,3883,1123,-1319,2429,15,4,459,-54,-30,379,-84
12/22/2022,6713879,23115,6530276,160488,15893,1515024,2980,405,1534302,3385,1053,-1293,2322,22,3,798,-479,-19,303,-498
12/23/2022,6714802,21207,6533088,160507,15895,1515641,2673,373,1534582,3046,923,-1908,2812,19,2,617,-307,-32,280,-339
12/24/2022,6715586,20680,6534382,160524,15898,1516168,2398,372,1534836,2770,784,-527,1294,17,3,527,-275,-1,254,-276
12/25/2022,6716124,20231,6535356,160537,15900,1516573,2203,372,1535048,2575,538,-449,974,13,2,405,-195,0,212,-195
12/26/2022,6716592,17473,6538568,160551,15901,1516949,1994,341,1535185,2335,468,-2758,3212,14,1,376,-209,-31,137,-240
12/27/2022,6717395,16575,6540260,160560,15901,1517259,1888,322,1535370,2210,803,-898,1692,9,0,310,-106,-19,185,-125
12/28/2022,6718090,14725,6542791,160574,15903,1517512,1881,304,1535600,2185,695,-1850,2531,14,2,253,-7,-18,230,-25
12/29/2022,6718775,13964,6544228,160583,15904,1517906,1672,307,1535789,1979,685,-761,1437,9,1,394,-209,3,189,-206
12/30/2022,6719327,13602,6545132,160593,15906,1518186,1592,286,1535970,1878,552,-362,904,10,2,280,-80,-21,181,-101
12/31/2022,6719815,9871,6549332,160612,15909,1518494,1441,282,1536126,1723,488,-3731,4200,19,3,308,-151,-4,156,-155
1/1/2023,6720181,9577,6549985,160619,15911,1518805,1258,282,1536256,1540,366,-294,653,7,2,311,-183,0,130,-183
1/2/2023,6720443,9131,6550677,160635,15913,1519020,1133,259,1536325,1392,262,-446,692,16,2,215,-125,-23,69,-148
1/3/2023,6721095,8970,6551477,160648,15914,1519229,1127,247,1536517,1374,652,-161,800,13,1,209,-6,-12,192,-18
1/4/2023,6721692,8893,6552142,160657,15915,1519353,1237,222,1536727,1459,597,-77,665,9,1,124,110,-25,210,85
1/5/2023,6722227,8740,6552822,160665,15916,1519553,1227,214,1536910,1441,535,-153,680,8,1,200,-10,-8,183,-18
1/6/2023,6722746,8687,6553386,160673,15918,1519752,1213,215,1537098,1428,519,-53,564,8,2,199,-14,1,188,-13
1/7/2023,6723201,8456,6554066,160679,15920,1519945,1175,209,1537249,1384,455,-231,680,6,2,193,-38,-6,151,-44
1/8/2023,6723546,8368,6554495,160683,15921,1520133,1111,209,1537374,1320,345,-88,429,4,1,188,-64,0,125,-64
1/9/2023,6723812,8066,6555052,160694,15924,1520284,1045,202,1537455,1267,266,-302,557,11,3,151,-66,-7,81,-53
1/10/2023,6724281,7920,6555664,160697,15925,1520387,1058,209,1537579,1267,469,-146,612,3,1,103,13,7,124,0
1/11/2023,6724683,7805,6556173,160705,15926,1520477,1113,209,1537725,1322,402,-115,509,8,1,90,55,0,146,55
1/12/2023,6725095,7542,6556842,160711,15926,1520713,1069,176,1537884,1245,412,-263,669,6,0,236,-44,-33,159,-77
1/13/2023,6725458,7426,6557313,160719,15928,1520897,989,190,1538004,1179,363,-116,471,8,2,184,-80,14,120,-66
1/14/2023,6725847,7288,6557835,160724,15928,1521132,933,183,1538176,1116,389,-138,522,5,0,235,-56,-7,172,-63
1/15/2023,6726086,7158,6558201,160727,15929,1521280,858,193,1538260,1051,239,-130,366,3,1,148,-75,10,84,-65
1/16/2023,6726311,6841,6558731,160739,15929,1521435,773,193,1538330,966,225,-317,530,12,0,155,-85,0,70,-85
1/17/2023,6726668,6619,6559303,160746,15929,1521629,685,198,1538441,883,357,-222,572,7,0,194,-88,5,111,-83
1/18/2023,6727007,6515,6559736,160756,15931,1521707,744,177,1538559,921,339,-104,433,10,2,78,59,-21,118,38
1/19/2023,6727317,6382,6560171,160764,15934,1521791,740,178,1538643,918,310,-133,435,8,3,84,-4,1,84,-3
1/20/2023,6727609,5979,6560858,160772,15936,1521917,706,176,1538735,882,292,-403,687,8,2,126,-34,-2,92,-36
1/21/2023,6727847,5607,6561463,160777,15937,1522083,619,177,1538816,796,238,-372,605,5,1,166,-87,1,81,-86
1/22/2023,6728065,5461,6561823,160781,15939,1522186,613,162,1538900,775,218,-146,360,4,2,103,-6,-15,84,-21
1/23/2023,6728184,5128,6562268,160788,15939,1522288,556,162,1538945,718,119,-333,445,7,0,102,-57,0,45,-57
1/24/2023,6728402,4888,6562721,160793,15940,1522374,542,151,1539007,693,218,-240,453,5,1,86,-14,-11,62,-25
1/25/2023,6728676,4821,6563060,160795,15941,1522427,576,150,1539094,726,274,-67,339,2,1,53,34,-1,87,33
1/26/2023,6728998,4600,6563599,160799,15941,1522544,562,144,1539191,706,322,-221,539,4,0,117,-14,-6,97,-20
1/27/2023,6729209,4526,6563882,160801,15941,1522655,515,144,1539255,659,211,-74,283,2,0,111,-47,0,64,-47
1/28/2023,6729209,4526,6563882,160801,15941,1522740,507,137,1539325,644,0,0,0,0,0,85,-8,-7,70,-15
1/29/2023,6729573,4435,6564335,160803,15942,1522817,497,132,1539388,629,364,-91,453,2,1,77,-10,-5,63,-15
1/30/2023,6729756,4277,6564669,160810,15942,1522903,489,122,1539456,611,183,-158,334,7,0,86,-8,-10,68,-18
1/31/2023,6730016,4270,6564932,160814,15942,1522973,509,129,1539553,638,260,-7,263,4,0,70,20,7,97,27
2/1/2023,6730289,4264,6565208,160817,15942,1523015,531,145,1539633,676,273,-6,276,3,0,42,22,16,80,38
2/2/2023,6730537,4304,6565411,160822,15942,1523068,595,129,1539734,724,248,40,203,5,0,53,64,-16,101,48
2/3/2023,6730778,4268,6565684,160826,15944,1523178,540,134,1539796,674,241,-36,273,4,2,110,-55,5,62,-50
2/4/2023,6730964,4216,6565917,160831,15946,1523262,523,126,1539857,649,186,-52,233,5,2,84,-17,-8,61,-25
2/5/2023,6731135,4205,6566098,160832,15946,1523334,504,124,1539908,628,171,-11,181,1,0,72,-19,-2,51,-21
2/6/2023,6731304,4062,6566404,160838,15947,1523440,463,127,1539977,590,169,-143,306,6,1,106,-41,3,69,-38
2/7/2023,6731696,4186,6566663,160847,15948,1523491,611,127,1540177,738,392,124,259,9,1,51,148,0,200,148
2/8/2023,6731959,4195,6566912,160852,15949,1523556,634,128,1540267,762,263,9,249,5,1,65,23,1,90,24
2/9/2023,6732179,4155,6567169,160855,15949,1523659,633,114,1540355,747,220,-40,257,3,0,103,-1,-14,88,-15
2/10/2023,6732418,4116,6567444,160858,15950,1523757,645,107,1540459,752,239,-39,275,3,1,98,12,-7,104,5
2/11/2023,6732618,4103,6567655,160860,15951,1523850,643,107,1540551,750,200,-13,211,2,1,93,-2,0,92,-2
2/12/2023,6732799,4092,6567843,160864,15952,1523936,633,106,1540627,739,181,-11,188,4,1,86,-10,-1,76,-11
2/13/2023,6732968,3989,6568109,160870,15952,1524010,628,110,1540700,738,169,-103,266,6,0,74,-5,4,73,-1
2/14/2023,6733215,4024,6568318,160873,15954,1524096,630,109,1540789,739,247,35,209,3,2,86,2,-1,89,1
2/15/2023,6733478,4126,6568474,160878,15955,1524158,666,111,1540890,777,263,102,156,5,1,62,36,2,101,38
2/16/2023,6733697,4136,6568681,160880,15955,1524271,662,111,1540999,773,219,10,207,2,0,113,-4,0,109,-4
2/17/2023,6733912,4144,6568884,160884,15957,1524333,711,111,1541112,822,215,8,203,4,2,62,49,0,113,49
2/18/2023,6734102,3720,6569498,160884,15957,1524433,698,111,1541199,809,190,-424,614,0,0,100,-13,0,87,-13
2/19/2023,6734215,3657,6569672,160886,15958,1524529,660,111,1541258,771,113,-63,174,2,1,96,-38,0,59,-38
2/20/2023,6734334,3536,6569910,160888,15958,1524625,612,111,1541306,723,119,-121,238,2,0,96,-48,0,48,-48
2/21/2023,6734606,3604,6570110,160892,15960,1524774,565,104,1541403,669,272,68,200,4,2,149,-47,-7,97,-54
2/22/2023,6734818,3619,6570305,160894,15960,1524774,637,124,1541495,761,212,15,195,2,0,0,72,20,92,92
2/23/2023,6735033,3566,6570570,160897,15961,1524888,595,125,1541569,720,215,-53,265,3,1,114,-42,1,74,-41
2/24/2023,6735259,3571,6570796,160902,15962,1524989,593,122,1541666,715,226,5,226,5,1,101,-2,-3,97,-5
2/25/2023,6735451,3583,6570963,160905,15963,1525083,592,106,1541744,698,192,12,167,3,1,94,-1,-16,78,-17
2/26/2023,6735628,3533,6571187,160908,15963,1525184,567,106,1541820,673,177,-50,224,3,0,101,-25,0,76,-25
2/27/2023,6735780,3412,6571457,160911,15963,1525260,545,101,1541869,646,152,-121,270,3,0,76,-22,-5,49,-27
2/28/2023,6736046,3440,6571692,160914,15963,1525330,571,106,1541970,677,266,28,235,3,0,70,26,5,101,31
3/1/2023,6736298,3537,6571845,160916,15964,1525387,612,101,1542064,713,252,97,153,2,1,57,41,-5,94,36
3/2/2023,6736576,3558,6572098,160920,15964,1525473,627,106,1542170,733,278,21,253,4,0,86,15,5,106,20
3/3/2023,6736787,3530,6572332,160925,15964,1525556,640,105,1542265,745,211,-28,234,5,0,83,13,-1,95,12
3/4/2023,6736994,3457,6572609,160928,15964,1525658,638,105,1542365,743,207,-73,277,3,0,102,-2,0,100,-2
3/5/2023,6737159,3044,6573185,160930,15964,1525751,623,105,1542443,728,165,-413,576,2,0,93,-15,0,78,-15
3/6/2023,6737303,2968,6573403,160932,15964,1525812,611,109,1542496,720,144,-76,218,2,0,61,-12,4,53,-8
3/7/2023,6737606,2923,6573749,160934,15964,1525880,663,116,1542623,779,303,-45,346,2,0,68,52,7,127,59
3/8/2023,6737918,3095,6573886,160937,15965,1525930,758,122,1542775,880,312,172,137,3,1,50,95,6,152,101
3/9/2023,6738225,3107,6547117,160941,15966,1526038,786,127,1542917,913,307,12,-26769,4,1,108,28,5,142,33
3/10/2023,6738520,3203,6574373,160944,15966,1526138,841,126,1543071,967,295,96,27256,3,0,100,55,-1,154,54
3/11/2023,6738844,3325,6574574,160945,15966,1526249,851,129,1543195,980,324,122,201,1,0,111,10,3,124,13
3/12/2023,6739067,3331,6574788,160948,15967,1526350,864,129,1543310,993,223,6,214,3,1,101,13,0,115,13
3/13/2023,6739289,3240,6575099,160950,15967,1526428,893,134,1543422,1027,222,-91,311,2,0,78,29,5,112,34
3/14/2023,6739669,3366,6575350,160953,15968,1526501,953,135,1543557,1088,380,126,251,3,1,73,60,1,135,61
3/15/2023,6740031,3534,6575541,160956,15969,1526566,1049,138,1543722,1187,362,168,191,3,1,65,96,3,165,99
3/16/2023,6740404,3666,6575775,160963,15970,1526700,1094,132,1543896,1226,373,132,234,7,1,134,45,-6,174,39
3/17/2023,6740727,3701,6576058,160968,15972,1526854,1071,151,1544048,1222,323,35,283,5,2,154,-23,19,152,-4
3/18/2023,6741082,3777,6576336,160969,15973,1527032,1033,167,1544205,1200,355,76,278,1,1,178,-38,16,157,-22
3/19/2023,6741354,3841,6576542,160971,15973,1527158,1035,167,1544333,1202,272,64,206,2,0,126,2,0,128,2
3/20/2023,6741588,3660,6576953,160975,15974,1527286,1002,171,1544433,1173,234,-181,411,4,1,128,-33,4,100,-29
3/21/2023,6742061,3809,6577275,160997,15974,1527390,1101,170,1544635,1271,473,149,322,22,0,104,99,-1,202,98
3/22/2023,6742510,4100,6577428,160982,15975,1527482,1235,167,1544859,1402,449,291,153,-15,1,92,134,-3,224,131
3/23/2023,6742814,4178,6577652,160984,15975,1527670,1204,160,1545009,1364,304,78,224,2,0,188,-31,-7,150,-38
3/24/2023,6743171,4244,6577942,160985,15975,1527826,1193,160,1545154,1353,357,66,290,1,0,156,-11,0,145,-11
3/25/2023,6743607,4352,6578261,160994,15977,1527956,1233,161,1545327,1394,436,108,319,9,2,130,40,1,173,41
3/26/2023,6744033,4532,6578507,160994,15977,1528117,1277,161,1545532,1438,426,180,246,0,0,161,44,0,205,44
3/27/2023,6744362,4425,6578937,161000,15977,1528299,1232,161,1545669,1393,329,-107,430,6,0,182,-45,0,137,-45
3/28/2023,6744873,4755,6579113,161005,15978,1528397,1355,173,1545903,1528,511,330,176,5,1,98,123,12,234,135
3/29/2023,6745453,4861,6579584,161008,15978,1528500,1504,161,1546143,1665,580,106,471,3,0,103,149,-12,240,137
3/30/2023,6746009,5012,6579985,161012,15978,1528772,1451,182,1546383,1633,556,151,401,4,0,272,-53,21,240,-32
3/31/2023,6746474,5226,6580228,161020,15981,1528900,1521,177,1546579,1698,465,214,243,8,3,128,70,-5,196,65
4/1/2023,6746960,5410,6580527,161023,15982,1529197,1449,170,1546798,1619,486,184,299,3,1,297,-72,-7,219,-79
4/2/2023,6747363,5655,6580681,161027,15982,1529197,1631,190,1547000,1821,403,245,154,4,0,0,182,20,202,202
4/3/2023,6747692,5549,6581113,161030,15982,1529380,1595,179,1547136,1774,329,-106,432,3,0,183,-36,-11,136,-47
4/4/2023,6748308,5837,6581436,161035,15984,1529543,1658,186,1547371,1844,616,288,323,5,2,163,63,7,235,70
4/5/2023,6748973,5945,6581989,161039,15985,1529673,1786,207,1547651,1993,665,108,553,4,1,130,128,21,280,149
4/6/2023,6749564,6111,6582409,161044,15986,1529868,1878,197,1547929,2075,591,166,420,5,1,195,92,-10,278,82
4/7/2023,6750183,6360,6582777,161046,15987,1530107,1916,214,1548224,2130,619,249,368,2,1,239,38,17,295,55
4/8/2023,6750603,6419,6583134,161050,15988,1530341,1886,199,1548414,2085,420,59,357,4,1,234,-30,-15,190,-45
4/9/2023,6751168,6686,6583430,161052,15988,1530593,1829,209,1548619,2038,565,267,296,2,0,252,-57,10,205,-47
4/10/2023,6751662,6599,6584006,161057,15988,1530909,1735,209,1548841,1944,494,-87,576,5,0,316,-94,0,222,-94
4/11/2023,6752606,6827,6584708,161071,15992,1531074,1922,226,1549214,2148,944,228,702,14,4,165,187,17,373,204
4/12/2023,6753593,7457,6585054,161082,15996,1531162,2283,248,1549689,2531,987,630,346,11,4,88,361,22,475,383
4/13/2023,6754583,7719,6585768,161096,16000,1531554,2321,255,1550130,2576,990,262,714,14,4,392,38,7,441,45
4/14/2023,6755600,8259,6586231,161110,16004,1531835,2513,264,1550616,2777,1017,540,463,14,4,281,192,9,486,201
4/15/2023,6756541,8689,6586736,161116,16006,1532062,2679,264,1551011,2943,941,430,505,6,2,227,166,0,395,166
4/16/2023,6757445,9041,6587281,161123,16006,1532303,2849,265,1551423,3114,904,352,545,7,0,241,170,1,412,171
4/17/2023,6758170,9024,6588017,161129,16009,1532483,2959,266,1551717,3225,725,-17,736,6,3,180,110,1,294,111
4/18/2023,6759513,9776,6588597,161140,16017,1532321,3607,315,1552260,3922,1343,752,580,11,8,-162,648,49,543,697
4/19/2023,6760755,10448,6589155,161152,16017,1532844,3607,315,1552783,3922,1242,672,558,12,0,523,0,0,523,0
4/20/2023,6761900,10881,6589854,161165,16017,1533354,3607,315,1553293,3922,1145,433,699,13,0,510,0,0,510,0
4/21/2023,6762804,11002,6590632,161170,16017,1533856,3489,315,1553677,3804,904,121,778,5,0,502,-118,0,384,-118
4/22/2023,6763556,11141,6591239,161176,16018,1534128,3505,303,1553954,3808,752,139,607,6,1,272,16,-12,277,4
4/23/2023,6763940,10576,6592187,161177,16018,1534806,2958,303,1554085,3261,384,-565,948,1,0,678,-547,0,131,-547
4/24/2023,6764560,10580,6592798,161182,16019,1535143,2809,303,1554274,3112,620,4,611,5,1,337,-149,0,189,-149
4/25/2023,6765727,10898,6593639,161190,16019,1535535,2814,303,1554671,3117,1167,318,841,8,0,392,5,0,397,5
4/26/2023,6767126,11092,6594830,161204,16023,1535844,2864,303,1555034,3167,1399,194,1191,14,4,309,50,0,363,50
4/27/2023,6769005,11129,6596655,161221,16027,1536382,2786,382,1555577,3168,1879,37,1825,17,4,538,-78,79,543,1
4/28/2023,6771072,11849,6597965,161258,16033,1537020,2792,388,1556233,3180,2067,720,1310,37,6,638,6,6,656,12
4/29/2023,6773146,13099,6598775,161272,16034,1537356,3146,401,1556937,3547,2074,1250,810,14,1,336,354,13,704,367
4/30/2023,6774721,13843,6599594,161284,16034,1537756,3376,401,1557567,3777,1575,744,819,12,0,400,230,0,630,230
5/1/2023,6775613,13880,6600433,161300,16037,1538012,3381,405,1557835,3786,892,37,839,16,3,256,5,4,268,9
5/2/2023,6776984,14205,6601452,161327,16040,1538160,3624,423,1558247,4047,1371,325,1019,27,3,148,243,18,412,261
5/3/2023,6779631,15707,6602572,161352,16041,1538449,4133,435,1559058,4568,2647,1502,1120,25,1,289,509,12,811,521
5/4/2023,6782048,16953,6603711,161384,16043,1538846,4529,425,1559843,4954,2417,1246,1139,32,2,397,396,-10,785,386
5/5/2023,6784170,17909,6604857,161404,16046,1539214,4847,433,1560540,5280,2122,956,1146,20,3,368,318,8,697,326
5/6/2023,6786059,18480,6606140,161439,16050,1539874,4781,421,1561126,5202,1889,571,1283,35,4,660,-66,-12,586,-78
5/7/2023,6787354,18496,6607399,161459,16053,1540404,4728,409,1561594,5137,1295,16,1259,20,3,530,-53,-12,468,-65
5/8/2023,6788503,17829,6609194,161480,16054,1541192,4283,400,1561929,4683,1149,-667,1795,21,1,788,-445,-9,335,-454
5/9/2023,6790405,18426,6610478,161501,16060,1541361,4618,396,1562435,5014,1902,597,1284,21,6,169,335,-4,506,331
5/10/2023,6792173,18877,6611770,161526,16060,1541979,4618,396,1563053,5014,1768,451,1292,25,0,618,0,0,618,0
5/11/2023,6793750,19067,6613136,161547,16065,1542446,4658,367,1563536,5025,1577,190,1366,21,5,467,40,-29,483,11
5/12/2023,6795221,18918,6614729,161574,16068,1543196,4392,350,1564006,4742,1471,-149,1593,27,3,750,-266,-17,470,-283
5/13/2023,6796466,18542,6616325,161599,16074,1544099,3898,339,1564410,4237,1245,-376,1596,25,6,903,-494,-11,404,-505
5/14/2023,6797336,18179,6617548,161609,16076,1544767,3566,318,1564727,3884,870,-363,1223,10,2,668,-332,-21,317,-353
5/15/2023,6798097,16677,6619790,161630,16080,1545339,3239,302,1564960,3541,761,-1502,2242,21,4,572,-327,-16,233,-343
5/16/2023,6798736,16553,6620545,161638,16082,1545690,3020,299,1565091,3319,639,-124,755,8,2,351,-219,-3,131,-222
5/17/2023,6799760,16558,6621556,161646,16082,1546668,2350,262,1565362,2612,1024,5,1011,8,0,978,-670,-37,271,-707
5/18/2023,6800425,16305,6622467,161653,16082,1546668,2476,319,1565545,2795,665,-253,911,7,0,0,126,57,183,183
5/19/2023,,,,,16082,1547197,2073,312,1565664,2385,-6800425,-16305,-6622467,-161653,0,529,-403,-7,119,-410
5/20/2023,6801615,15707,6624237,161671,16088,1547902,1569,274,1565833,1843,6801615,15707,6624237,161671,6,705,-504,-38,169,-542
5/21/2023,6802090,15207,6625209,161674,16088,1548022,1569,274,1565953,1843,475,-500,972,3,0,120,0,0,120,0
5/22/2023,6802514,14657,6626174,161683,16090,1548472,1198,274,1566034,1472,424,-550,965,9,2,450,-371,0,81,-371
5/23/2023,,,,,16094,1548719,1169,243,1566225,1412,-6802514,-14657,-6626174,-161683,4,247,-29,-31,191,-60
5/24/2023,,,,,16096,1548896,1117,251,1566360,1368,0,0,0,0,2,177,-52,8,135,-44
5/25/2023,,,,,16097,1549089,1073,232,1566491,1305,0,0,0,0,1,193,-44,-19,131,-63
5/26/2023,,,,,16097,1549283,1002,232,1566614,1234,0,0,0,0,0,194,-71,0,123,-71
5/27/2023,,,,,16099,1549329,1070,222,1566720,1292,0,0,0,0,2,46,68,-10,106,58
5/28/2023,,,,,16099,1549596,876,219,1566790,1095,0,0,0,0,0,267,-194,-3,70,-197
5/29/2023,,,,,16102,1549783,758,218,1566861,976,0,0,0,0,3,187,-118,-1,71,-119
5/30/2023,,,,,16102,1549893,780,211,1566986,991,0,0,0,0,0,110,22,-7,125,15
5/31/2023,,,,,16103,1549977,814,200,1567094,1014,0,0,0,0,1,84,34,-11,108,23
6/1/2023,,,,,16103,1550291,625,160,1567179,785,0,0,0,0,0,314,-189,-40,85,-229
6/2/2023,,,,,16103,1550293,643,187,1567226,830,0,0,0,0,0,2,18,27,47,45
6/3/2023,,,,,16103,1550420,572,187,1567282,759,0,0,0,0,0,127,-71,0,56,-71
6/4/2023,,,,,16104,1550534,513,179,1567330,692,0,0,0,0,1,114,-59,-8,48,-67
6/5/2023,,,,,16104,1550648,452,179,1567383,631,0,0,0,0,0,114,-61,0,53,-61
6/6/2023,,,,,16105,1550715,466,176,1567462,642,0,0,0,0,1,67,14,-3,79,11
6/7/2023,,,,,16107,1550773,495,160,1567535,655,0,0,0,0,2,58,29,-16,73,13
6/8/2023,,,,,16107,1550907,420,159,1567593,579,0,0,0,0,0,134,-75,-1,58,-76
6/9/2023,,,,,16108,1551044,354,128,1567634,482,0,0,0,0,1,137,-66,-31,41,-97
6/10/2023,,,,,16108,1551094,354,128,1567684,482,0,0,0,0,0,50,0,0,50,0
6/11/2023,,,,,16108,1551137,346,128,1567719,474,0,0,0,0,0,43,-8,0,35,-8
6/12/2023,,,,,16109,1551189,325,128,1567751,453,0,0,0,0,1,52,-21,0,32,-21
6/13/2023,,,,,16109,1551238,323,119,1567789,442,0,0,0,0,0,49,-2,-9,38,-11
6/14/2023,,,,,16109,1551278,323,127,1567837,450,0,0,0,0,0,40,0,8,48,8
6/15/2023,,,,,16112,1551355,293,116,1567876,409,0,0,0,0,3,77,-30,-11,39,-41
6/16/2023,,,,,16112,1551427,260,110,1567909,370,0,0,0,0,0,72,-33,-6,33,-39
6/17/2023,,,,,16112,1551481,236,110,1567939,346,0,0,0,0,0,54,-24,0,30,-24
6/18/2023,,,,,16112,1551521,220,103,1567956,323,0,0,0,0,0,40,-16,-7,17,-23
6/19/2023,,,,,16112,1551582,173,102,1567969,275,0,0,0,0,0,61,-47,-1,13,-48
6/20/2023,,,,,16113,1551614,177,102,1568006,279,0,0,0,0,1,32,4,0,37,4
6/21/2023,,,,,16113,1551649,173,95,1568030,268,0,0,0,0,0,35,-4,-7,24,-11
6/22/2023,,,,,16113,1551687,161,95,1568056,256,0,0,0,0,0,38,-12,0,26,-12
6/23/2023,,,,,16114,1551731,159,82,1568086,241,0,0,0,0,1,44,-2,-13,30,-15
6/24/2023,,,,,16114,1551764,146,82,1568106,228,0,0,0,0,0,33,-13,0,20,-13
6/25/2023,,,,,16115,1551803,139,67,1568124,206,0,0,0,0,1,39,-7,-15,18,-22
6/26/2023,,,,,16115,1551828,124,67,1568134,191,0,0,0,0,0,25,-15,0,10,-15
6/27/2023,,,,,16115,1551845,126,67,1568153,193,0,0,0,0,0,17,2,0,19,2
6/28/2023,,,,,16115,1551857,129,63,1568164,192,0,0,0,0,0,12,3,-4,11,-1
6/29/2023,,,,,16115,1551896,117,44,1568172,161,0,0,0,0,0,39,-12,-19,8,-31
6/30/2023,,,,,16115,1551920,106,42,1568183,148,0,0,0,0,0,24,-11,-2,11,-13
